# FROM-URL	TO-URL
/ja/docs/A_XUL_Bestiary	/ja/docs/Archive/Mozilla/XUL/A_XUL_Bestiary
/ja/docs/Accessibility/AT-APIs	/ja/docs/Mozilla/Tech/Accessibility/AT-APIs
/ja/docs/Accessibility/AT-APIs/Gecko	/ja/docs/Mozilla/Tech/Accessibility/AT-APIs/Gecko
/ja/docs/Accessibility/AT-APIs/Gecko/Roles	/ja/docs/Mozilla/Tech/Accessibility/AT-APIs/Gecko/Roles
/ja/docs/Accessibility/AT-APIs/Gecko/Roles/ROLE_CHARACTER	/ja/docs/Mozilla/Tech/Accessibility/AT-APIs/Gecko/Roles/ROLE_CHARACTER
/ja/docs/Accessibility:AT-APIs:Gecko:Roles	/ja/docs/Mozilla/Tech/Accessibility/AT-APIs/Gecko/Roles
/ja/docs/Accessibility:AT-APIs:Gecko:Roles:ROLE_CHARACTER	/ja/docs/Mozilla/Tech/Accessibility/AT-APIs/Gecko/Roles/ROLE_CHARACTER
/ja/docs/Accessible_XUL_Authoring_Guidelines	/ja/docs/Archive/Mozilla/XUL/XUL_accessibility_guidelines
/ja/docs/Accessing_the_Windows_Registry_Using_XPCOM	/ja/docs/Mozilla/Tech/XPCOM/Accessing_the_Windows_Registry_Using_XPCOM
/ja/docs/Addons/Add-on_Manager	/ja/docs/Mozilla/Add-ons/Add-on_Manager
/ja/docs/Addons/Add-on_Manager/AddonAuthor	/ja/docs/Mozilla/Add-ons/Add-on_Manager/AddonAuthor
/ja/docs/Addons/Add-on_Manager/AddonScreenshot	/ja/docs/Mozilla/Add-ons/Add-on_Manager/AddonScreenshot
/ja/docs/Addons/Add-on_Manager/Code_Samples	/ja/docs/Mozilla/Add-ons/Add-on_Manager/Code_Samples
/ja/docs/Apps/Advanced_topics	/ja/docs/Archive/Apps/Advanced_topics
/ja/docs/Building_XULRunner_with_Python	/ja/docs/Archive/Mozilla/XULRunner/Building_XULRunner_with_Python
/ja/docs/CSS/:-moz-system-metric(images-in-menus)	/ja/docs/Archive/Web/CSS/:-moz-system-metric/images-in-menus
/ja/docs/CSS/:-moz-system-metric(windows-default-theme)	/ja/docs/Archive/Web/CSS/:-moz-system-metric/windows-default-theme
/ja/docs/CSS/:-moz-tree-cell	/ja/docs/Mozilla/Gecko/Chrome/CSS/::-moz-tree-cell
/ja/docs/CSS/:-moz-tree-cell-text	/ja/docs/Mozilla/Gecko/Chrome/CSS/::-moz-tree-cell-text
/ja/docs/CSS/:-moz-tree-cell-text(hover)	/ja/docs/Mozilla/Gecko/Chrome/CSS/::-moz-tree-cell-text(hover)
/ja/docs/CSS/:-moz-tree-column	/ja/docs/Mozilla/Gecko/Chrome/CSS/::-moz-tree-column
/ja/docs/CSS/:-moz-tree-drop-feedback	/ja/docs/Mozilla/Gecko/Chrome/CSS/::-moz-tree-drop-feedback
/ja/docs/CSS/:-moz-tree-image	/ja/docs/Mozilla/Gecko/Chrome/CSS/::-moz-tree-image
/ja/docs/CSS/:-moz-tree-indentation	/ja/docs/Mozilla/Gecko/Chrome/CSS/::-moz-tree-indentation
/ja/docs/CSS/:-moz-tree-line	/ja/docs/Mozilla/Gecko/Chrome/CSS/::-moz-tree-line
/ja/docs/CSS/:-moz-tree-progressmeter	/ja/docs/Mozilla/Gecko/Chrome/CSS/::-moz-tree-progressmeter
/ja/docs/CSS/:-moz-tree-row	/ja/docs/Mozilla/Gecko/Chrome/CSS/::-moz-tree-row
/ja/docs/CSS/:-moz-tree-row(hover)	/ja/docs/Mozilla/Gecko/Chrome/CSS/::-moz-tree-row(hover)
/ja/docs/CSS/:-moz-tree-separator	/ja/docs/Mozilla/Gecko/Chrome/CSS/::-moz-tree-separator
/ja/docs/CSS/:-moz-tree-twisty	/ja/docs/Mozilla/Gecko/Chrome/CSS/::-moz-tree-twisty
/ja/docs/CSS::-moz-system-metric(images-in-menus)	/ja/docs/Archive/Web/CSS/:-moz-system-metric/images-in-menus
/ja/docs/CSS::-moz-system-metric(windows-default-theme)	/ja/docs/Archive/Web/CSS/:-moz-system-metric/windows-default-theme
/ja/docs/CSS::-moz-tree-cell	/ja/docs/Mozilla/Gecko/Chrome/CSS/::-moz-tree-cell
/ja/docs/CSS::-moz-tree-cell-text	/ja/docs/Mozilla/Gecko/Chrome/CSS/::-moz-tree-cell-text
/ja/docs/CSS::-moz-tree-cell-text(hover)	/ja/docs/Mozilla/Gecko/Chrome/CSS/::-moz-tree-cell-text(hover)
/ja/docs/CSS::-moz-tree-column	/ja/docs/Mozilla/Gecko/Chrome/CSS/::-moz-tree-column
/ja/docs/CSS::-moz-tree-drop-feedback	/ja/docs/Mozilla/Gecko/Chrome/CSS/::-moz-tree-drop-feedback
/ja/docs/CSS::-moz-tree-image	/ja/docs/Mozilla/Gecko/Chrome/CSS/::-moz-tree-image
/ja/docs/CSS::-moz-tree-indentation	/ja/docs/Mozilla/Gecko/Chrome/CSS/::-moz-tree-indentation
/ja/docs/CSS::-moz-tree-line	/ja/docs/Mozilla/Gecko/Chrome/CSS/::-moz-tree-line
/ja/docs/CSS::-moz-tree-progressmeter	/ja/docs/Mozilla/Gecko/Chrome/CSS/::-moz-tree-progressmeter
/ja/docs/CSS::-moz-tree-row	/ja/docs/Mozilla/Gecko/Chrome/CSS/::-moz-tree-row
/ja/docs/CSS::-moz-tree-row(hover)	/ja/docs/Mozilla/Gecko/Chrome/CSS/::-moz-tree-row(hover)
/ja/docs/CSS::-moz-tree-separator	/ja/docs/Mozilla/Gecko/Chrome/CSS/::-moz-tree-separator
/ja/docs/CSS::-moz-tree-twisty	/ja/docs/Mozilla/Gecko/Chrome/CSS/::-moz-tree-twisty
/ja/docs/Cert_override.txt	/ja/docs/Archive/Misc_top_level/Cert_override.txt
/ja/docs/Choosing_Standards_Compliance_Over_Proprietary_Practices	/ja/docs/Archive/Web_Standards/Choosing_Standards_Compliance_Over_Proprietary_Practices
/ja/docs/Chrome_Registration	/ja/docs/Mozilla/Chrome_Registration
/ja/docs/Chrome_test	/ja/docs/Mozilla/QA/Chrome_tests
/ja/docs/Chrome_tests	/ja/docs/Mozilla/QA/Chrome_tests
/ja/docs/Code_snippets/Signing_a_XPI	/ja/docs/Archive/Add-ons/Signing_a_XPI
/ja/docs/Code_snippets:Signing_a_XPI	/ja/docs/Archive/Add-ons/Signing_a_XPI
/ja/docs/Command_Line_Options	/ja/docs/Mozilla/Command_Line_Options
/ja/docs/Components.Constructor	/ja/docs/Mozilla/Tech/XPCOM/Language_Bindings/Components.Constructor
/ja/docs/Components.Exception	/ja/docs/Mozilla/Tech/XPCOM/Language_Bindings/Components.Exception
/ja/docs/Components.ID	/ja/docs/Mozilla/Tech/XPCOM/Language_Bindings/Components.ID
/ja/docs/Components.classes	/ja/docs/Mozilla/Tech/XPCOM/Language_Bindings/Components.classes
/ja/docs/Components.classesByID	/ja/docs/Mozilla/Tech/XPCOM/Language_Bindings/Components.classesByID
/ja/docs/Components.interfaces	/ja/docs/Mozilla/Tech/XPCOM/Language_Bindings/Components.interfaces
/ja/docs/Components.lastResult	/ja/docs/Mozilla/Tech/XPCOM/Language_Bindings/Components.lastResult
/ja/docs/Components.manager	/ja/docs/Mozilla/Tech/XPCOM/Language_Bindings/Components.manager
/ja/docs/Components.results	/ja/docs/Mozilla/Tech/XPCOM/Language_Bindings/Components.results
/ja/docs/Components.returnCode	/ja/docs/Mozilla/Tech/XPCOM/Language_Bindings/Components.returnCode
/ja/docs/Components.stack	/ja/docs/Mozilla/Tech/XPCOM/Language_Bindings/Components.stack
/ja/docs/Components.utils	/ja/docs/Mozilla/Tech/XPCOM/Language_Bindings/Components.utils
/ja/docs/Components.utils.evalInSandbox	/ja/docs/Mozilla/Tech/XPCOM/Language_Bindings/Components.utils.evalInSandbox
/ja/docs/Components.utils.forceGC	/ja/docs/Mozilla/Tech/XPCOM/Language_Bindings/Components.utils.forceGC
/ja/docs/Components.utils.getWeakReference	/ja/docs/Mozilla/Tech/XPCOM/Language_Bindings/Components.utils.getWeakReference
/ja/docs/Components.utils.import	/ja/docs/Mozilla/Tech/XPCOM/Language_Bindings/Components.utils.import
/ja/docs/Components.utils.reportError	/ja/docs/Mozilla/Tech/XPCOM/Language_Bindings/Components.utils.reportError
/ja/docs/Components_object	/ja/docs/Mozilla/Tech/XPCOM/Language_Bindings/Components_object
/ja/docs/Console_service	/ja/docs/Mozilla/Tech/XPCOM/Reference/XPCOM_Interface_Reference/nsIConsoleService
/ja/docs/Core_JavaScript_1.5_Reference/Global_Objects/Object/eval	/ja/docs/Archive/Web/JavaScript/Object.eval
/ja/docs/Core_JavaScript_1.5_Reference/Global_Objects/Object/noSuchMethod	/ja/docs/Archive/Web/JavaScript/Object.noSuchMethod
/ja/docs/Core_JavaScript_1.5_Reference/Global_Objects/Object/unwatch	/ja/docs/Archive/Web/JavaScript/Object.unwatch
/ja/docs/Core_JavaScript_1.5_Reference/Global_Objects/Object/watch	/ja/docs/Archive/Web/JavaScript/Object.watch
/ja/docs/Core_JavaScript_1.5_Reference:Global_Objects:Object:eval	/ja/docs/Archive/Web/JavaScript/Object.eval
/ja/docs/Core_JavaScript_1.5_Reference:Global_Objects:Object:unwatch	/ja/docs/Archive/Web/JavaScript/Object.unwatch
/ja/docs/Core_JavaScript_1.5_Reference:Global_Objects:Object:watch	/ja/docs/Archive/Web/JavaScript/Object.watch
/ja/docs/DOM/App	/ja/docs/Archive/B2G_OS/API/DOMApplication
/ja/docs/DOM/TelephonyCall	/ja/docs/Archive/B2G_OS/API/TelephonyCall
/ja/docs/DOM/Whitespace_template	/ja/docs/Trash/Whitespace_template
/ja/docs/DOM/window.navigator.mozApps	/ja/docs/Archive/B2G_OS/API/Navigator/mozApps
/ja/docs/DOM:Whitespace_template	/ja/docs/Trash/Whitespace_template
/ja/docs/Describing_microformats_in_JavaScript	/ja/docs/Archive/Web_Standards/Describing_microformats_in_JavaScript
/ja/docs/Dialogs_in_XULRunner	/ja/docs/Archive/Mozilla/XULRunner/Dialogs_in_XULRunner
/ja/docs/Embedding_Mozilla	/ja/docs/Gecko/Embedding_Mozilla
/ja/docs/Embedding_SpiderMonkey	/ja/docs/Mozilla/Projects/SpiderMonkey/JSAPI_User_Guide
/ja/docs/Enhanced_Extension_Installation	/ja/docs/Archive/Add-ons/Enhanced_Extension_Installation
/ja/docs/Extension	/ja/docs/Extensions
/ja/docs/Extension_Versioning,_Update_and_Compatibility	/ja/docs/Archive/Add-ons/Extension_Versioning,_Update_and_Compatibility
/ja/docs/FC_Login	/ja/docs/Mozilla/Projects/NSS/NSS_reference/FC_Login
/ja/docs/FileGuide	/ja/docs/Archive/Mozilla/XUL/FileGuide
/ja/docs/FileGuide/FileInfo	/ja/docs/Archive/Mozilla/XUL/FileGuide/FileInfo
/ja/docs/FileGuide/MoveCopyDelete	/ja/docs/Archive/Mozilla/XUL/FileGuide/MoveCopyDelete
/ja/docs/FileGuide:FileInfo	/ja/docs/Archive/Mozilla/XUL/FileGuide/FileInfo
/ja/docs/FileGuide:MoveCopyDelete	/ja/docs/Archive/Mozilla/XUL/FileGuide/MoveCopyDelete
/ja/docs/Fun_With_XBL_and_XPConnect	/ja/docs/Mozilla/Tech/XPCOM/Fun_With_XBL_and_XPConnect
/ja/docs/Generating_GUID	/ja/docs/Mozilla/Tech/XPCOM/Generating_GUIDs
/ja/docs/Generating_GUIDs	/ja/docs/Mozilla/Tech/XPCOM/Generating_GUIDs
/ja/docs/Generic_factory	/ja/docs/Mozilla/Tech/XPCOM/Generic_factory
/ja/docs/Getting_started_with_XULRunner	/ja/docs/Archive/Mozilla/XULRunner/Getting_started_with_XULRunner
/ja/docs/How_to_Build_an_XPCOM_Component_in_Javascript	/ja/docs/Mozilla/Tech/XPCOM/Guide/How_to_Build_an_XPCOM_Component_in_Javascript
/ja/docs/How_to_Create_Windows_Inno_Setup_Installer_for_XULRunner_Application	/ja/docs/Archive/Mozilla/XULRunner/How_to_Create_Windows_Inno_Setup_Installer_for_XULRunner_Application
/ja/docs/How_to_Quit_a_XUL_Application	/ja/docs/Archive/Mozilla/XUL/How_to_Quit_a_XUL_Application
/ja/docs/How_to_embed_the_JavaScript_engine	/ja/docs/Mozilla/Projects/SpiderMonkey/How_to_embed_the_JavaScript_engine
/ja/docs/Interfacing_with_the_XPCOM_cycle_collector	/ja/docs/Mozilla/Tech/XPCOM/Interfacing_with_the_XPCOM_cycle_collector
/ja/docs/International_characters_in_XUL_JavaScript	/ja/docs/Archive/Mozilla/XUL/International_characters_in_XUL_JavaScript
/ja/docs/Introduction_to_Network_Security_Services	/ja/docs/Mozilla/Projects/NSS/Introduction_to_Network_Security_Services
/ja/docs/Introduction_to_XPCOM_for_the_DOM	/ja/docs/Mozilla/Tech/XPCOM/Introduction_to_XPCOM_for_the_DOM
/ja/docs/Introduction_to_XUL	/ja/docs/Archive/Mozilla/XUL/Introduction_to_XUL
/ja/docs/Introduction_to_the_JavaScript_shell	/ja/docs/Mozilla/Projects/SpiderMonkey/Introduction_to_the_JavaScript_shell
/ja/docs/Issues_Arising_From_Arbitrary-Element_hover	/ja/docs/Archive/Web_Standards/Issues_Arising_From_Arbitrary-Element_hover
/ja/docs/JSAPI_Reference	/ja/docs/Mozilla/Projects/SpiderMonkey/JSAPI_reference
/ja/docs/JSAPI_Reference/Alphabetical_List	/ja/docs/Mozilla/Projects/SpiderMonkey/JSAPI_reference/Alphabetical_List
/ja/docs/JSAPI_Reference/JSRuntime	/ja/docs/Mozilla/Projects/SpiderMonkey/JSAPI_reference/JSRuntime
/ja/docs/JSAPI_Reference/JSType	/ja/docs/Mozilla/Projects/SpiderMonkey/JSAPI_reference/JSType
/ja/docs/JSAPI_Reference/JS_CompileFile	/ja/docs/Mozilla/Projects/SpiderMonkey/JSAPI_reference/JS_CompileFile
/ja/docs/JSAPI_Reference/JS_ConstructObject	/ja/docs/Mozilla/Projects/SpiderMonkey/JSAPI_reference/JS_ConstructObject
/ja/docs/JSAPI_Reference/JS_DefineObject	/ja/docs/Mozilla/Projects/SpiderMonkey/JSAPI_reference/JS_DefineObject
/ja/docs/JSAPI_Reference/JS_DestroyContext	/ja/docs/Mozilla/Projects/SpiderMonkey/JSAPI_reference/JS_DestroyContext
/ja/docs/JSAPI_Reference/JS_DestroyRuntime	/ja/docs/Mozilla/Projects/SpiderMonkey/JSAPI_reference/JS_DestroyRuntime
/ja/docs/JSAPI_Reference/JS_EvaluateScript	/ja/docs/Mozilla/Projects/SpiderMonkey/JSAPI_reference/JS_EvaluateScript
/ja/docs/JSAPI_Reference/JS_GetRuntime	/ja/docs/Mozilla/Projects/SpiderMonkey/JSAPI_reference/JS_GetRuntime
/ja/docs/JSAPI_Reference/JS_GetRuntimePrivate	/ja/docs/Mozilla/Projects/SpiderMonkey/JSAPI_reference/JS_GetRuntimePrivate
/ja/docs/JSAPI_Reference/JS_Init	/ja/docs/Mozilla/Projects/SpiderMonkey/JSAPI_reference/JS_Init
/ja/docs/JSAPI_Reference/JS_Lock	/ja/docs/Mozilla/Projects/SpiderMonkey/JSAPI_reference/JS_Lock
/ja/docs/JSAPI_Reference/JS_NewContext	/ja/docs/Mozilla/Projects/SpiderMonkey/JSAPI_reference/JS_NewContext
/ja/docs/JSAPI_Reference/JS_NewObject	/ja/docs/Mozilla/Projects/SpiderMonkey/JSAPI_reference/JS_NewObject
/ja/docs/JSAPI_Reference/JS_NewRuntime	/ja/docs/Mozilla/Projects/SpiderMonkey/JSAPI_reference/JS_NewRuntime
/ja/docs/JSAPI_Reference/JS_ShutDown	/ja/docs/Mozilla/Projects/SpiderMonkey/JSAPI_reference/JS_ShutDown
/ja/docs/JSAPI_Reference/jsint	/ja/docs/Mozilla/Projects/SpiderMonkey/JSAPI_reference/jsint
/ja/docs/JSAPI_Reference:Alphabetical_List	/ja/docs/Mozilla/Projects/SpiderMonkey/JSAPI_reference/Alphabetical_List
/ja/docs/JSContext	/ja/docs/SpiderMonkey/JSAPI_Reference/JSRuntime
/ja/docs/JSDBGAPI_Reference	/ja/docs/Mozilla/Projects/SpiderMonkey/JSDBGAPI_Reference
/ja/docs/JSRuntime	/ja/docs/SpiderMonkey/JSAPI_Reference/JSRuntime
/ja/docs/JS_CompileFile	/ja/docs/SpiderMonkey/JSAPI_Reference/JS_CompileFile
/ja/docs/JS_CompileScript	/ja/docs/Sandbox/JS_CompileScript
/ja/docs/JS_CompileUCScript	/ja/docs/Sandbox/JS_CompileScript
/ja/docs/JS_ConstructObject	/ja/docs/SpiderMonkey/JSAPI_Reference/JS_ConstructObject
/ja/docs/JS_DefineObject	/ja/docs/SpiderMonkey/JSAPI_Reference/JS_DefineObject
/ja/docs/JS_DestroyContext	/ja/docs/SpiderMonkey/JSAPI_Reference/JS_DestroyContext
/ja/docs/JS_DestroyContextMaybeGC	/ja/docs/SpiderMonkey/JSAPI_Reference/JS_DestroyContext
/ja/docs/JS_DestroyContextNoGC	/ja/docs/SpiderMonkey/JSAPI_Reference/JS_DestroyContext
/ja/docs/JS_DestroyRuntime	/ja/docs/SpiderMonkey/JSAPI_Reference/JS_DestroyRuntime
/ja/docs/JS_EvaluateScript	/ja/docs/SpiderMonkey/JSAPI_Reference/JS_EvaluateScript
/ja/docs/JS_EvaluateUCScript	/ja/docs/SpiderMonkey/JSAPI_Reference/JS_EvaluateScript
/ja/docs/JS_GetRuntime	/ja/docs/SpiderMonkey/JSAPI_Reference/JS_GetRuntime
/ja/docs/JS_GetRuntimePrivate	/ja/docs/SpiderMonkey/JSAPI_Reference/JS_GetRuntimePrivate
/ja/docs/JS_NewContext	/ja/docs/SpiderMonkey/JSAPI_Reference/JS_NewContext
/ja/docs/JS_NewObject	/ja/docs/SpiderMonkey/JSAPI_Reference/JS_NewObject
/ja/docs/JS_NewRuntime	/ja/docs/SpiderMonkey/JSAPI_Reference/JS_NewRuntime
/ja/docs/JS_SetRuntimePrivate	/ja/docs/SpiderMonkey/JSAPI_Reference/JS_GetRuntimePrivate
/ja/docs/JS_ShutDown	/ja/docs/SpiderMonkey/JSAPI_Reference/JS_ShutDown
/ja/docs/JavaScript/Reference/Global_Objects/Function/arity	/ja/docs/Archive/Web/JavaScript/Function.arity
/ja/docs/JavaScript/Reference/Global_Objects/Function/isGenerator	/ja/docs/Archive/Web/JavaScript/Function.isGenerator
/ja/docs/JavaScript/Reference/Global_Objects/Object/Parent	/ja/docs/Archive/Web/JavaScript/Object.parent
/ja/docs/JavaScript/Reference/Global_Objects/Object/eval	/ja/docs/Archive/Web/JavaScript/Object.eval
/ja/docs/JavaScript/Reference/Global_Objects/Object/noSuchMethod	/ja/docs/Archive/Web/JavaScript/Object.noSuchMethod
/ja/docs/JavaScript/Reference/Global_Objects/Object/unwatch	/ja/docs/Archive/Web/JavaScript/Object.unwatch
/ja/docs/JavaScript/Reference/Global_Objects/Object/watch	/ja/docs/Archive/Web/JavaScript/Object.watch
/ja/docs/JavaScript/Reference/Global_Objects/Object/watch-redirect-1	/ja/docs/Archive/Web/JavaScript/Object.watch
/ja/docs/JavaScript_C_Engine_Embedder's_Guide	/ja/docs/SpiderMonkey/Embedding_SpiderMonkey
/ja/docs/JavaScript_code_modules	/ja/docs/Mozilla/JavaScript_code_modules
/ja/docs/JavaScript_code_modules/PopupNotifications.jsm	/ja/docs/Mozilla/JavaScript_code_modules/PopupNotifications.jsm
/ja/docs/JavaScript_code_modules/Using	/ja/docs/Mozilla/JavaScript_code_modules/Using
/ja/docs/JavaScript_code_modules/ctypes.jsm	/ja/docs/Mozilla/JavaScript_code_modules/ctypes.jsm
/ja/docs/JavaXPCOM	/ja/docs/Mozilla/Tech/XPCOM/Language_Bindings/JavaXPCOM
/ja/docs/JavaXPCOM/Development	/ja/docs/Mozilla/Tech/XPCOM/Language_Bindings/JavaXPCOM/Development
/ja/docs/JavaXPCOM/Embedding_Mozilla_in_a_Java_Application_using_JavaXPCOM	/ja/docs/Mozilla/Tech/XPCOM/Language_Bindings/JavaXPCOM/Embedding_Mozilla_in_a_Java_Application_using_JavaXPCOM
/ja/docs/JavaXPCOM/Examples	/ja/docs/Mozilla/Tech/XPCOM/Language_Bindings/JavaXPCOM/Examples
/ja/docs/JavaXPCOM/Other_Resources	/ja/docs/Mozilla/Tech/XPCOM/Language_Bindings/JavaXPCOM/Other_Resources
/ja/docs/JavaXPCOM:Development	/ja/docs/Mozilla/Tech/XPCOM/Language_Bindings/JavaXPCOM/Development
/ja/docs/JavaXPCOM:Embedding_Mozilla_in_a_Java_Application_using_JavaXPCOM	/ja/docs/Mozilla/Tech/XPCOM/Language_Bindings/JavaXPCOM/Embedding_Mozilla_in_a_Java_Application_using_JavaXPCOM
/ja/docs/JavaXPCOM:Examples	/ja/docs/Mozilla/Tech/XPCOM/Language_Bindings/JavaXPCOM/Examples
/ja/docs/LDAP_Support_in_Thunderbird	/ja/docs/Mozilla/Thunderbird/LDAP_Support
/ja/docs/Localizing_an_extension	/ja/docs/Archive/Localizing_an_extension
/ja/docs/MCD,_Mission_Control_Desktop_AKA_AutoConfig	/ja/docs/Archive/Misc_top_level/MCD,_Mission_Control_Desktop_AKA_AutoConfig
/ja/docs/Mobile	/ja/docs/Mozilla/Mobile
/ja/docs/Mobile/Firefox_Mobile_for_developers	/ja/docs/Mozilla/Mobile/Firefox_Mobile_for_developers
/ja/docs/Mobile/Viewport_meta_tag	/ja/docs/Mozilla/Mobile/Viewport_meta_tag
/ja/docs/Mochitest	/ja/docs/Mozilla/Projects/Mochitest
/ja/docs/Modularization_Techniques	/ja/docs/Archive/Mozilla/Modularization_Techniques
/ja/docs/Mozilla/Tech/XPCOM/Guide/Mozilla_internal_string_guide	https://firefox-source-docs.mozilla.org/xpcom/stringguide.html
/ja/docs/Mozilla's_DOCTYPE_sniffing	/ja/docs/Archive/Web_Standards/Mozilla_s_DOCTYPE_sniffing
/ja/docs/Mozilla_internal_string_guide	/ja/docs/Mozilla/Tech/XPCOM/Guide/Mozilla_internal_string_guide
/ja/docs/Multiple_Item_Packaging	/ja/docs/Archive/Add-ons/Multiple_Item_Packaging
/ja/docs/NSPR	/ja/docs/Mozilla/Projects/NSPR
/ja/docs/NSPR/About_NSPR	/ja/docs/Mozilla/Projects/NSPR/About_NSPR
/ja/docs/NSPR/Using_IO_Timeout_and_Interrupt_on_NT_(External)	/ja/docs/Mozilla/Projects/NSPR/Using_IO_Timeout_and_Interrupt_on_NT_(External)
/ja/docs/NSPR:Using_IO_Timeout_and_Interrupt_on_NT_(External)	/ja/docs/Mozilla/Projects/NSPR/Using_IO_Timeout_and_Interrupt_on_NT_(External)
/ja/docs/NSPR_API_Reference	/ja/docs/Mozilla/Projects/NSPR/Reference
/ja/docs/NSPR_API_Reference/Date_and_Time	/ja/docs/Mozilla/Projects/NSPR/Reference/Date_and_Time
/ja/docs/NSPR_API_Reference/Introduction_to_NSPR	/ja/docs/Mozilla/Projects/NSPR/Reference/Introduction_to_NSPR
/ja/docs/NSPR_API_Reference/Logging	/ja/docs/Mozilla/Projects/NSPR/Reference/Logging
/ja/docs/NSPR_API_Reference/Memory_Management_Operations	/ja/docs/Mozilla/Projects/NSPR/Reference/Memory_Management_Operations
/ja/docs/NSPR_API_Reference/NSPR_LOG_MODULES	/ja/docs/Mozilla/Projects/NSPR/Reference/NSPR_LOG_MODULES
/ja/docs/NSPR_API_Reference:Date_and_Time	/ja/docs/Mozilla/Projects/NSPR/Reference/Date_and_Time
/ja/docs/NSPR_API_Reference:Memory_Management_Operations	/ja/docs/Mozilla/Projects/NSPR/Reference/Memory_Management_Operations
/ja/docs/NS_ENSURE_TRUE	/ja/docs/Mozilla/Tech/XPCOM/Reference/NS_ENSURE_TRUE
/ja/docs/Notes_on_TLS_-_SSL_3.0_Intolerant_Servers	/ja/docs/Mozilla/Projects/NSS/Notes_on_TLS_-_SSL_3.0_Intolerant_Servers
/ja/docs/NsIDOMSimpleGestureEvent	/ja/docs/Mozilla/Tech/XPCOM/Reference/XPCOM_Interface_Reference/NsIDOMSimpleGestureEvent
/ja/docs/NsIPlacesView	/ja/docs/Mozilla/Tech/XPCOM/Reference/XPCOM_Interface_Reference/NsIPlacesView
/ja/docs/Observer_Notifications	/ja/docs/Archive/Add-ons/Observer_Notifications
/ja/docs/Open_Web_apps_and_Web_standards	/ja/docs/Archive/B2G_OS/Quickstart/Open_Web_apps_and_Web_standards
/ja/docs/Opening_a_Link_in_the_Default_Browser	/ja/docs/Archive/Mozilla/XULRunner/Opening_a_Link_in_the_Default_Browser
/ja/docs/Overlay	/ja/docs/XUL_Overlays
/ja/docs/Overview_of_NSS	/ja/docs/Mozilla/Projects/NSS/Overview_of_NSS
/ja/docs/PKCS11	/ja/docs/Mozilla/Projects/NSS/PKCS11
/ja/docs/Parsing_microformats_in_JavaScript	/ja/docs/Archive/Web_Standards/Parsing_microformats_in_JavaScript
/ja/docs/PlXPCOM	/ja/docs/Mozilla/Tech/XPCOM/Language_Bindings/PlXPCOM
/ja/docs/PyXPCOM	/ja/docs/Mozilla/Tech/XPCOM/Language_Bindings/PyXPCOM
/ja/docs/QA	/ja/docs/Mozilla/QA
/ja/docs/RDF_in_Fifty_Words_or_Less	/ja/docs/Archive/Web_Standards/RDF_in_Fifty_Words_or_Less
/ja/docs/RDF_in_Mozilla_FAQ	/ja/docs/Archive/Web_Standards/RDF_in_Mozilla_FAQ
/ja/docs/ROLE_CHARACTER	/ja/docs/Mozilla/Tech/Accessibility/AT-APIs/Gecko/Roles/ROLE_CHARACTER
/ja/docs/RSS	/ja/docs/Archive/RSS
/ja/docs/RSS/Element	/ja/docs/Archive/RSS/Element
/ja/docs/RSS/Getting_Started	/ja/docs/Archive/RSS/Getting_Started
/ja/docs/RSS/Other_Resources	/ja/docs/Archive/RSS/Other_Resources
/ja/docs/RSS/Version	/ja/docs/Archive/RSS/Version
/ja/docs/RSS/Version/0.90	/ja/docs/Archive/RSS/Version/0.90
/ja/docs/RSS/Version/0.91	/ja/docs/Archive/RSS/Version/0.91
/ja/docs/RSS:Getting_Started	/ja/docs/Archive/RSS/Getting_Started
/ja/docs/RSS:Version	/ja/docs/Archive/RSS/Version
/ja/docs/RSS:Version:0.90	/ja/docs/Archive/RSS/Version/0.90
/ja/docs/RSS:Version:0.91	/ja/docs/Archive/RSS/Version/0.91
/ja/docs/RbXPCOM	/ja/docs/Mozilla/Tech/XPCOM/Language_Bindings/RbXPCOM
/ja/docs/Remote_debugging	/ja/docs/Archive/Mozilla/Remote_debugging
/ja/docs/Repackaging_Firefox	/ja/docs/Archive/Mozilla/Firefox/Repackaging_Firefox
/ja/docs/SOAP_in_Gecko-based_Browsers	/ja/docs/Archive/Mozilla/Firefox/SOAP_in_Gecko-based_Browsers
/ja/docs/Same-origin_policy_for_file:_URIs	/ja/docs/Archive/Misc_top_level/Same-origin_policy_for_file:_URIs
/ja/docs/Session_restore_API	/ja/docs/Archive/Add-ons/Session_store_API
/ja/docs/Session_store_API	/ja/docs/Archive/Add-ons/Session_store_API
/ja/docs/Setting_HTTP_request_headers	/ja/docs/Mozilla/Tech/XPCOM/Setting_HTTP_request_headers
/ja/docs/Setting_up_an_update_server	/ja/docs/Mozilla/Setting_up_an_update_server
/ja/docs/Signing_a_XPI	/ja/docs/Archive/Add-ons/Signing_a_XPI
/ja/docs/Signing_an_extension	/ja/docs/Archive/Add-ons/Signing_an_extension
/ja/docs/Skinning_XUL_Files_by_Hand	/ja/docs/Archive/Mozilla/XUL/Tutorial/Skinning_XUL_Files_by_Hand
/ja/docs/Source_code_directories_overview	/ja/docs/Archive/Misc_top_level/Source_code_directories_overview
/ja/docs/SpecialPowers	/ja/docs/Mozilla/Projects/Mochitest/SpecialPowers
/ja/docs/Storage	/ja/docs/Mozilla/Tech/XPCOM/Storage
/ja/docs/Styling_Abbreviations_and_Acronyms	/ja/docs/Archive/Web_Standards/Styling_Abbreviations_and_Acronyms
/ja/docs/Supporting_search_suggestions_in_search_plugins	/ja/docs/Archive/Add-ons/Supporting_search_suggestions_in_search_plugins
/ja/docs/The_Business_Benefits_of_Web_Standards	/ja/docs/Archive/Web_Standards/The_Business_Benefits_of_Web_Standards
/ja/docs/The_Joy_of_XUL	/ja/docs/Archive/Mozilla/XUL/The_Joy_of_XUL
/ja/docs/The_Thread_Manager	/ja/docs/Mozilla/Tech/XPCOM/The_Thread_Manager
/ja/docs/Toolkit_version_format	/ja/docs/Mozilla/Toolkit_version_format
/ja/docs/Tools/Firefox_OS_Simulator	/ja/docs/Archive/B2G_OS/Simulator
/ja/docs/Tools/Firefox_OS_Simulator/Simulator_Walkthrough	/ja/docs/Archive/B2G_OS/Simulator/Simulator_Walkthrough
/ja/docs/Tools/Remote_Debugging/Firefox_for_Metro	/ja/docs/Archive/Mozilla/Remote_debugging/Firefox_for_Metro
/ja/docs/Tree_Widget_Changes	/ja/docs/Archive/Mozilla/XUL/Tree_Widget_Changes
/ja/docs/Uriloader	/ja/docs/Archive/Mozilla/Uriloader
/ja/docs/Using_Crash_Reporting_in_a_XULRunner_Application	/ja/docs/Archive/Mozilla/XULRunner/Using_Crash_Reporting_in_a_XULRunner_Application
/ja/docs/Using_JavaScript_code_modules_(redirect)	/ja/docs/Mozilla/JavaScript_code_modules/Using
/ja/docs/Using_Web_Standards_in_your_Web_Pages	/ja/docs/Archive/Using_Web_Standards_in_your_Web_Pages
/ja/docs/Using_Web_Standards_in_your_Web_Pages/Developing_Cross_Browser_Cross_Platform_Pages	/ja/docs/Archive/Using_Web_Standards_in_your_Web_Pages/Developing_Cross_Browser_Cross_Platform_Pages
/ja/docs/Using_Web_Standards_in_your_Web_Pages/Making_your_page_using_web_standards_-_how_to	/ja/docs/Archive/Using_Web_Standards_in_your_Web_Pages/Making_your_page_using_web_standards_-_how_to
/ja/docs/Using_Web_Standards_in_your_Web_Pages/Summary_of_Changes	/ja/docs/Archive/Using_Web_Standards_in_your_Web_Pages/Summary_of_Changes
/ja/docs/Using_Web_Standards_in_your_Web_Pages/Using_the_W3C_DOM	/ja/docs/Archive/Using_Web_Standards_in_your_Web_Pages/Using_the_W3C_DOM
/ja/docs/Using_Web_Standards_in_your_Web_Pages:Developing_Cross_Browser_Cross_Platform_Pages	/ja/docs/Archive/Using_Web_Standards_in_your_Web_Pages/Developing_Cross_Browser_Cross_Platform_Pages
/ja/docs/Using_Web_Standards_in_your_Web_Pages:Making_your_page_using_web_standards_-_how_to	/ja/docs/Archive/Using_Web_Standards_in_your_Web_Pages/Making_your_page_using_web_standards_-_how_to
/ja/docs/Using_Web_Standards_in_your_Web_Pages:Summary_of_Changes	/ja/docs/Archive/Using_Web_Standards_in_your_Web_Pages/Summary_of_Changes
/ja/docs/Using_Web_Standards_in_your_Web_Pages:Using_the_W3C_DOM	/ja/docs/Archive/Using_Web_Standards_in_your_Web_Pages/Using_the_W3C_DOM
/ja/docs/Using_XML_Data_Islands_in_Mozilla	/ja/docs/Archive/Misc_top_level/Using_XML_Data_Islands_in_Mozilla
/ja/docs/Using_content_preferences	/ja/docs/Archive/Misc_top_level/Using_content_preferences
/ja/docs/Using_microformats	/ja/docs/Archive/Mozilla/Firefox/Using_microformats
/ja/docs/Using_nsCOMPtr	/ja/docs/Mozilla/Tech/XPCOM/Using_nsCOMPtr
/ja/docs/Using_nsCOMPtr/Frequently_Asked_Questions	/ja/docs/Mozilla/Tech/XPCOM/Using_nsCOMPtr/Frequently_Asked_Questions
/ja/docs/Using_nsCOMPtr/Getting_Started_Guide	/ja/docs/Mozilla/Tech/XPCOM/Using_nsCOMPtr/Getting_Started_Guide
/ja/docs/Using_nsCOMPtr/Reference_Manual	/ja/docs/Mozilla/Tech/XPCOM/Using_nsCOMPtr/Reference_Manual
/ja/docs/Using_nsCOMPtr/Status,_Recent_Changes,_and_Plans	/ja/docs/Mozilla/Tech/XPCOM/Using_nsCOMPtr/Status,_Recent_Changes,_and_Plans
/ja/docs/Using_nsCOMPtr:Frequently_Asked_Questions	/ja/docs/Mozilla/Tech/XPCOM/Using_nsCOMPtr/Frequently_Asked_Questions
/ja/docs/Using_nsCOMPtr:Getting_Started_Guide	/ja/docs/Mozilla/Tech/XPCOM/Using_nsCOMPtr/Getting_Started_Guide
/ja/docs/Using_nsCOMPtr:Reference_Manual	/ja/docs/Mozilla/Tech/XPCOM/Using_nsCOMPtr/Reference_Manual
/ja/docs/Using_nsCOMPtr:Status,_Recent_Changes,_and_Plans	/ja/docs/Mozilla/Tech/XPCOM/Using_nsCOMPtr/Status,_Recent_Changes,_and_Plans
/ja/docs/Using_spell_checking_in_XUL	/ja/docs/Archive/Mozilla/XUL/Using_spell_checking_in_XUL
/ja/docs/Using_the_Stylesheet_Service	/ja/docs/Archive/Add-ons/Using_the_Stylesheet_Service
/ja/docs/Weak_reference	/ja/docs/Mozilla/Tech/XPCOM/Weak_reference
/ja/docs/Web/API/App	/ja/docs/Archive/B2G_OS/API/DOMApplication
/ja/docs/Web/API/BluetoothManager_(Firefox_OS)	/ja/docs/Archive/B2G_OS/API/BluetoothManager
/ja/docs/Web/API/BluetoothManager_(Firefox_OS)/enabled	/ja/docs/Archive/B2G_OS/API/BluetoothManager/enabled
/ja/docs/Web/API/BluetoothManager_(Firefox_OS)/getDefaultAdapter	/ja/docs/Archive/B2G_OS/API/BluetoothManager/getDefaultAdapter
/ja/docs/Web/API/BluetoothManager_(Firefox_OS)/isConnected	/ja/docs/Archive/B2G_OS/API/BluetoothManager/isConnected
/ja/docs/Web/API/BluetoothManager_(Firefox_OS)/onadapteradded	/ja/docs/Archive/B2G_OS/API/BluetoothManager/onadapteradded
/ja/docs/Web/API/BluetoothManager_(Firefox_OS)/ondisabled	/ja/docs/Archive/B2G_OS/API/BluetoothManager/ondisabled
/ja/docs/Web/API/BluetoothManager_(Firefox_OS)/onenabled	/ja/docs/Archive/B2G_OS/API/BluetoothManager/onenabled
/ja/docs/Web/API/DOMApplication	/ja/docs/Archive/B2G_OS/API/DOMApplication
/ja/docs/Web/API/Navigator.mozApps	/ja/docs/Archive/B2G_OS/API/Navigator/mozApps
/ja/docs/Web/API/Navigator.mozSetMessageHandler	/ja/docs/Archive/B2G_OS/API/Navigator/mozSetMessageHandler
/ja/docs/Web/API/Navigator/mozApps	/ja/docs/Archive/B2G_OS/API/Navigator/mozApps
/ja/docs/Web/API/Navigator/mozSetMessageHandler	/ja/docs/Archive/B2G_OS/API/Navigator/mozSetMessageHandler
/ja/docs/Web/API/TelephonyCall	/ja/docs/Archive/B2G_OS/API/TelephonyCall
/ja/docs/Web/API/Window.QueryInterface	/ja/docs/Mozilla/Tech/XPCOM/Reference/Interface/nsISupports
/ja/docs/Web/Accessibility/AT-APIs	/ja/docs/Mozilla/Tech/Accessibility/AT-APIs
/ja/docs/Web/Accessibility/AT-APIs/Gecko	/ja/docs/Mozilla/Tech/Accessibility/AT-APIs/Gecko
/ja/docs/Web/Accessibility/AT-APIs/Gecko/Roles	/ja/docs/Mozilla/Tech/Accessibility/AT-APIs/Gecko/Roles
/ja/docs/Web/Accessibility/AT-APIs/Gecko/Roles/ROLE_ACCEL_LABEL	/ja/docs/Mozilla/Tech/Accessibility/AT-APIs/Gecko/Roles/ROLE_ACCEL_LABEL
/ja/docs/Web/Accessibility/AT-APIs/Gecko/Roles/ROLE_ALERT	/ja/docs/Mozilla/Tech/Accessibility/AT-APIs/Gecko/Roles/ROLE_ALERT
/ja/docs/Web/Accessibility/AT-APIs/Gecko/Roles/ROLE_ANIMATION	/ja/docs/Mozilla/Tech/Accessibility/AT-APIs/Gecko/Roles/ROLE_ANIMATION
/ja/docs/Web/Accessibility/AT-APIs/Gecko/Roles/ROLE_APPLICATION	/ja/docs/Mozilla/Tech/Accessibility/AT-APIs/Gecko/Roles/ROLE_APPLICATION
/ja/docs/Web/Accessibility/AT-APIs/Gecko/Roles/ROLE_APP_ROOT	/ja/docs/Mozilla/Tech/Accessibility/AT-APIs/Gecko/Roles/ROLE_APP_ROOT
/ja/docs/Web/Accessibility/AT-APIs/Gecko/Roles/ROLE_ARROW	/ja/docs/Mozilla/Tech/Accessibility/AT-APIs/Gecko/Roles/ROLE_ARROW
/ja/docs/Web/Accessibility/AT-APIs/Gecko/Roles/ROLE_AUTOCOMPLETE	/ja/docs/Mozilla/Tech/Accessibility/AT-APIs/Gecko/Roles/ROLE_AUTOCOMPLETE
/ja/docs/Web/Accessibility/AT-APIs/Gecko/Roles/ROLE_BORDER	/ja/docs/Mozilla/Tech/Accessibility/AT-APIs/Gecko/Roles/ROLE_BORDER
/ja/docs/Web/Accessibility/AT-APIs/Gecko/Roles/ROLE_BUTTONDROPDOWN	/ja/docs/Mozilla/Tech/Accessibility/AT-APIs/Gecko/Roles/ROLE_BUTTONDROPDOWN
/ja/docs/Web/Accessibility/AT-APIs/Gecko/Roles/ROLE_BUTTONDROPDOWNGRID	/ja/docs/Mozilla/Tech/Accessibility/AT-APIs/Gecko/Roles/ROLE_BUTTONDROPDOWNGRID
/ja/docs/Web/Accessibility/AT-APIs/Gecko/Roles/ROLE_BUTTONMENU	/ja/docs/Mozilla/Tech/Accessibility/AT-APIs/Gecko/Roles/ROLE_BUTTONMENU
/ja/docs/Web/Accessibility/AT-APIs/Gecko/Roles/ROLE_CALENDAR	/ja/docs/Mozilla/Tech/Accessibility/AT-APIs/Gecko/Roles/ROLE_CALENDAR
/ja/docs/Web/Accessibility/AT-APIs/Gecko/Roles/ROLE_CANVAS	/ja/docs/Mozilla/Tech/Accessibility/AT-APIs/Gecko/Roles/ROLE_CANVAS
/ja/docs/Web/Accessibility/AT-APIs/Gecko/Roles/ROLE_CAPTION	/ja/docs/Mozilla/Tech/Accessibility/AT-APIs/Gecko/Roles/ROLE_CAPTION
/ja/docs/Web/Accessibility/AT-APIs/Gecko/Roles/ROLE_CARET	/ja/docs/Mozilla/Tech/Accessibility/AT-APIs/Gecko/Roles/ROLE_CARET
/ja/docs/Web/Accessibility/AT-APIs/Gecko/Roles/ROLE_CELL	/ja/docs/Mozilla/Tech/Accessibility/AT-APIs/Gecko/Roles/ROLE_CELL
/ja/docs/Web/Accessibility/AT-APIs/Gecko/Roles/ROLE_CHARACTER	/ja/docs/Mozilla/Tech/Accessibility/AT-APIs/Gecko/Roles/ROLE_CHARACTER
/ja/docs/Web/Accessibility/AT-APIs/Gecko/Roles/ROLE_CHART	/ja/docs/Mozilla/Tech/Accessibility/AT-APIs/Gecko/Roles/ROLE_CHART
/ja/docs/Web/Accessibility/AT-APIs/Gecko/Roles/ROLE_CHECKBUTTON	/ja/docs/Mozilla/Tech/Accessibility/AT-APIs/Gecko/Roles/ROLE_CHECKBUTTON
/ja/docs/Web/Accessibility/AT-APIs/Gecko/Roles/ROLE_CHECK_MENU_ITEM	/ja/docs/Mozilla/Tech/Accessibility/AT-APIs/Gecko/Roles/ROLE_CHECK_MENU_ITEM
/ja/docs/Web/Accessibility/AT-APIs/Gecko/Roles/ROLE_CHROME_WINDOW	/ja/docs/Mozilla/Tech/Accessibility/AT-APIs/Gecko/Roles/ROLE_CHROME_WINDOW
/ja/docs/Web/Accessibility/AT-APIs/Gecko/Roles/ROLE_CLOCK	/ja/docs/Mozilla/Tech/Accessibility/AT-APIs/Gecko/Roles/ROLE_CLOCK
/ja/docs/Web/Accessibility/AT-APIs/Gecko/Roles/ROLE_COLOR_CHOOSER	/ja/docs/Mozilla/Tech/Accessibility/AT-APIs/Gecko/Roles/ROLE_COLOR_CHOOSER
/ja/docs/Web/Accessibility/AT-APIs/Gecko/Roles/ROLE_COLUMNHEADER	/ja/docs/Mozilla/Tech/Accessibility/AT-APIs/Gecko/Roles/ROLE_COLUMNHEADER
/ja/docs/Web/Accessibility/AT-APIs/Gecko/Roles/ROLE_COMBOBOX	/ja/docs/Mozilla/Tech/Accessibility/AT-APIs/Gecko/Roles/ROLE_COMBOBOX
/ja/docs/Web/Accessibility/AT-APIs/Gecko/Roles/ROLE_COMBOBOX_LIST	/ja/docs/Mozilla/Tech/Accessibility/AT-APIs/Gecko/Roles/ROLE_COMBOBOX_LIST
/ja/docs/Web/Accessibility/AT-APIs/Gecko/Roles/ROLE_COMBOBOX_OPTION	/ja/docs/Mozilla/Tech/Accessibility/AT-APIs/Gecko/Roles/ROLE_COMBOBOX_OPTION
/ja/docs/Web/Accessibility/AT-APIs/Gecko/Roles/ROLE_CURSOR	/ja/docs/Mozilla/Tech/Accessibility/AT-APIs/Gecko/Roles/ROLE_CURSOR
/ja/docs/Web/Accessibility/AT-APIs/Gecko/Roles/ROLE_DATE_EDITOR	/ja/docs/Mozilla/Tech/Accessibility/AT-APIs/Gecko/Roles/ROLE_DATE_EDITOR
/ja/docs/Web/Accessibility/AT-APIs/Gecko/Roles/ROLE_DESKTOP_FRAME	/ja/docs/Mozilla/Tech/Accessibility/AT-APIs/Gecko/Roles/ROLE_DESKTOP_FRAME
/ja/docs/Web/Accessibility/AT-APIs/Gecko/Roles/ROLE_DESKTOP_ICON	/ja/docs/Mozilla/Tech/Accessibility/AT-APIs/Gecko/Roles/ROLE_DESKTOP_ICON
/ja/docs/Web/Accessibility/AT-APIs/Gecko/Roles/ROLE_DIAGRAM	/ja/docs/Mozilla/Tech/Accessibility/AT-APIs/Gecko/Roles/ROLE_DIAGRAM
/ja/docs/Web/Accessibility/AT-APIs/Gecko/Roles/ROLE_DIAL	/ja/docs/Mozilla/Tech/Accessibility/AT-APIs/Gecko/Roles/ROLE_DIAL
/ja/docs/Web/Accessibility/AT-APIs/Gecko/Roles/ROLE_DIALOG	/ja/docs/Mozilla/Tech/Accessibility/AT-APIs/Gecko/Roles/ROLE_DIALOG
/ja/docs/Web/Accessibility/AT-APIs/Gecko/Roles/ROLE_DIRECTORY_PANE	/ja/docs/Mozilla/Tech/Accessibility/AT-APIs/Gecko/Roles/ROLE_DIRECTORY_PANE
/ja/docs/Web/Accessibility/AT-APIs/Gecko/Roles/ROLE_DOCUMENT	/ja/docs/Mozilla/Tech/Accessibility/AT-APIs/Gecko/Roles/ROLE_DOCUMENT
/ja/docs/Web/Accessibility/AT-APIs/Gecko/Roles/ROLE_DOCUMENT_FRAME	/ja/docs/Mozilla/Tech/Accessibility/AT-APIs/Gecko/Roles/ROLE_DOCUMENT_FRAME
/ja/docs/Web/Accessibility/AT-APIs/Gecko/Roles/ROLE_DROPLIST	/ja/docs/Mozilla/Tech/Accessibility/AT-APIs/Gecko/Roles/ROLE_DROPLIST
/ja/docs/Web/Accessibility/AT-APIs/Gecko/Roles/ROLE_EDITBAR	/ja/docs/Mozilla/Tech/Accessibility/AT-APIs/Gecko/Roles/ROLE_EDITBAR
/ja/docs/Web/Accessibility/AT-APIs/Gecko/Roles/ROLE_ENTRY	/ja/docs/Mozilla/Tech/Accessibility/AT-APIs/Gecko/Roles/ROLE_ENTRY
/ja/docs/Web/Accessibility/AT-APIs/Gecko/Roles/ROLE_EQUATION	/ja/docs/Mozilla/Tech/Accessibility/AT-APIs/Gecko/Roles/ROLE_EQUATION
/ja/docs/Web/Accessibility/AT-APIs/Gecko/Roles/ROLE_FILE_CHOOSER	/ja/docs/Mozilla/Tech/Accessibility/AT-APIs/Gecko/Roles/ROLE_FILE_CHOOSER
/ja/docs/Web/Accessibility/AT-APIs/Gecko/Roles/ROLE_FONT_CHOOSER	/ja/docs/Mozilla/Tech/Accessibility/AT-APIs/Gecko/Roles/ROLE_FONT_CHOOSER
/ja/docs/Web/Accessibility/AT-APIs/Gecko/Roles/ROLE_FOOTER	/ja/docs/Mozilla/Tech/Accessibility/AT-APIs/Gecko/Roles/ROLE_FOOTER
/ja/docs/Web/Accessibility/AT-APIs/Gecko/Roles/ROLE_FORM	/ja/docs/Mozilla/Tech/Accessibility/AT-APIs/Gecko/Roles/ROLE_FORM
/ja/docs/Web/Accessibility/AT-APIs/Gecko/Roles/ROLE_GLASS_PANE	/ja/docs/Mozilla/Tech/Accessibility/AT-APIs/Gecko/Roles/ROLE_GLASS_PANE
/ja/docs/Web/Accessibility/AT-APIs/Gecko/Roles/ROLE_GRAPHIC	/ja/docs/Mozilla/Tech/Accessibility/AT-APIs/Gecko/Roles/ROLE_GRAPHIC
/ja/docs/Web/Accessibility/AT-APIs/Gecko/Roles/ROLE_GRIP	/ja/docs/Mozilla/Tech/Accessibility/AT-APIs/Gecko/Roles/ROLE_GRIP
/ja/docs/Web/Accessibility/AT-APIs/Gecko/Roles/ROLE_GROUPING	/ja/docs/Mozilla/Tech/Accessibility/AT-APIs/Gecko/Roles/ROLE_GROUPING
/ja/docs/Web/Accessibility/AT-APIs/Gecko/Roles/ROLE_HEADER	/ja/docs/Mozilla/Tech/Accessibility/AT-APIs/Gecko/Roles/ROLE_HEADER
/ja/docs/Web/Accessibility/AT-APIs/Gecko/Roles/ROLE_HEADING	/ja/docs/Mozilla/Tech/Accessibility/AT-APIs/Gecko/Roles/ROLE_HEADING
/ja/docs/Web/Accessibility/AT-APIs/Gecko/Roles/ROLE_HELPBALLOON	/ja/docs/Mozilla/Tech/Accessibility/AT-APIs/Gecko/Roles/ROLE_HELPBALLOON
/ja/docs/Web/Accessibility/AT-APIs/Gecko/Roles/ROLE_HOTKEYFIELD	/ja/docs/Mozilla/Tech/Accessibility/AT-APIs/Gecko/Roles/ROLE_HOTKEYFIELD
/ja/docs/Web/Accessibility/AT-APIs/Gecko/Roles/ROLE_HTML_CONTAINER	/ja/docs/Mozilla/Tech/Accessibility/AT-APIs/Gecko/Roles/ROLE_HTML_CONTAINER
/ja/docs/Web/Accessibility/AT-APIs/Gecko/Roles/ROLE_ICON	/ja/docs/Mozilla/Tech/Accessibility/AT-APIs/Gecko/Roles/ROLE_ICON
/ja/docs/Web/Accessibility/AT-APIs/Gecko/Roles/ROLE_IMAGE_MAP	/ja/docs/Mozilla/Tech/Accessibility/AT-APIs/Gecko/Roles/ROLE_IMAGE_MAP
/ja/docs/Web/Accessibility/AT-APIs/Gecko/Roles/ROLE_IME	/ja/docs/Mozilla/Tech/Accessibility/AT-APIs/Gecko/Roles/ROLE_IME
/ja/docs/Web/Accessibility/AT-APIs/Gecko/Roles/ROLE_INDICATOR	/ja/docs/Mozilla/Tech/Accessibility/AT-APIs/Gecko/Roles/ROLE_INDICATOR
/ja/docs/Web/Accessibility/AT-APIs/Gecko/Roles/ROLE_INTERNAL_FRAME	/ja/docs/Mozilla/Tech/Accessibility/AT-APIs/Gecko/Roles/ROLE_INTERNAL_FRAME
/ja/docs/Web/Accessibility/AT-APIs/Gecko/Roles/ROLE_IPADDRESS	/ja/docs/Mozilla/Tech/Accessibility/AT-APIs/Gecko/Roles/ROLE_IPADDRESS
/ja/docs/Web/Accessibility/AT-APIs/Gecko/Roles/ROLE_LABEL	/ja/docs/Mozilla/Tech/Accessibility/AT-APIs/Gecko/Roles/ROLE_LABEL
/ja/docs/Web/Accessibility/AT-APIs/Gecko/Roles/ROLE_LAYERED_PANE	/ja/docs/Mozilla/Tech/Accessibility/AT-APIs/Gecko/Roles/ROLE_LAYERED_PANE
/ja/docs/Web/Accessibility/AT-APIs/Gecko/Roles/ROLE_LINK	/ja/docs/Mozilla/Tech/Accessibility/AT-APIs/Gecko/Roles/ROLE_LINK
/ja/docs/Web/Accessibility/AT-APIs/Gecko/Roles/ROLE_LIST	/ja/docs/Mozilla/Tech/Accessibility/AT-APIs/Gecko/Roles/ROLE_LIST
/ja/docs/Web/Accessibility/AT-APIs/Gecko/Roles/ROLE_LISTBOX	/ja/docs/Mozilla/Tech/Accessibility/AT-APIs/Gecko/Roles/ROLE_LISTBOX
/ja/docs/Web/Accessibility/AT-APIs/Gecko/Roles/ROLE_LISTITEM	/ja/docs/Mozilla/Tech/Accessibility/AT-APIs/Gecko/Roles/ROLE_LISTITEM
/ja/docs/Web/Accessibility/AT-APIs/Gecko/Roles/ROLE_MENUBAR	/ja/docs/Mozilla/Tech/Accessibility/AT-APIs/Gecko/Roles/ROLE_MENUBAR
/ja/docs/Web/Accessibility/AT-APIs/Gecko/Roles/ROLE_MENUITEM	/ja/docs/Mozilla/Tech/Accessibility/AT-APIs/Gecko/Roles/ROLE_MENUITEM
/ja/docs/Web/Accessibility/AT-APIs/Gecko/Roles/ROLE_MENUPOPUP	/ja/docs/Mozilla/Tech/Accessibility/AT-APIs/Gecko/Roles/ROLE_MENUPOPUP
/ja/docs/Web/Accessibility/AT-APIs/Gecko/Roles/ROLE_NOTHING	/ja/docs/Mozilla/Tech/Accessibility/AT-APIs/Gecko/Roles/ROLE_NOTHING
/ja/docs/Web/Accessibility/AT-APIs/Gecko/Roles/ROLE_OPTION	/ja/docs/Mozilla/Tech/Accessibility/AT-APIs/Gecko/Roles/ROLE_OPTION
/ja/docs/Web/Accessibility/AT-APIs/Gecko/Roles/ROLE_OPTION_PANE	/ja/docs/Mozilla/Tech/Accessibility/AT-APIs/Gecko/Roles/ROLE_OPTION_PANE
/ja/docs/Web/Accessibility/AT-APIs/Gecko/Roles/ROLE_OUTLINE	/ja/docs/Mozilla/Tech/Accessibility/AT-APIs/Gecko/Roles/ROLE_OUTLINE
/ja/docs/Web/Accessibility/AT-APIs/Gecko/Roles/ROLE_OUTLINEITEM	/ja/docs/Mozilla/Tech/Accessibility/AT-APIs/Gecko/Roles/ROLE_OUTLINEITEM
/ja/docs/Web/Accessibility/AT-APIs/Gecko/Roles/ROLE_PAGE	/ja/docs/Mozilla/Tech/Accessibility/AT-APIs/Gecko/Roles/ROLE_PAGE
/ja/docs/Web/Accessibility/AT-APIs/Gecko/Roles/ROLE_PAGETAB	/ja/docs/Mozilla/Tech/Accessibility/AT-APIs/Gecko/Roles/ROLE_PAGETAB
/ja/docs/Web/Accessibility/AT-APIs/Gecko/Roles/ROLE_PAGETABLIST	/ja/docs/Mozilla/Tech/Accessibility/AT-APIs/Gecko/Roles/ROLE_PAGETABLIST
/ja/docs/Web/Accessibility/AT-APIs/Gecko/Roles/ROLE_PANE	/ja/docs/Mozilla/Tech/Accessibility/AT-APIs/Gecko/Roles/ROLE_PANE
/ja/docs/Web/Accessibility/AT-APIs/Gecko/Roles/ROLE_PARAGRAPH	/ja/docs/Mozilla/Tech/Accessibility/AT-APIs/Gecko/Roles/ROLE_PARAGRAPH
/ja/docs/Web/Accessibility/AT-APIs/Gecko/Roles/ROLE_PARENT_MENUITEM	/ja/docs/Mozilla/Tech/Accessibility/AT-APIs/Gecko/Roles/ROLE_PARENT_MENUITEM
/ja/docs/Web/Accessibility/AT-APIs/Gecko/Roles/ROLE_PASSWORD_TEXT	/ja/docs/Mozilla/Tech/Accessibility/AT-APIs/Gecko/Roles/ROLE_PASSWORD_TEXT
/ja/docs/Web/Accessibility/AT-APIs/Gecko/Roles/ROLE_POPUP_MENU	/ja/docs/Mozilla/Tech/Accessibility/AT-APIs/Gecko/Roles/ROLE_POPUP_MENU
/ja/docs/Web/Accessibility/AT-APIs/Gecko/Roles/ROLE_PROGRESSBAR	/ja/docs/Mozilla/Tech/Accessibility/AT-APIs/Gecko/Roles/ROLE_PROGRESSBAR
/ja/docs/Web/Accessibility/AT-APIs/Gecko/Roles/ROLE_PROPERTYPAGE	/ja/docs/Mozilla/Tech/Accessibility/AT-APIs/Gecko/Roles/ROLE_PROPERTYPAGE
/ja/docs/Web/Accessibility/AT-APIs/Gecko/Roles/ROLE_PUSHBUTTON	/ja/docs/Mozilla/Tech/Accessibility/AT-APIs/Gecko/Roles/ROLE_PUSHBUTTON
/ja/docs/Web/Accessibility/AT-APIs/Gecko/Roles/ROLE_RADIOBUTTON	/ja/docs/Mozilla/Tech/Accessibility/AT-APIs/Gecko/Roles/ROLE_RADIOBUTTON
/ja/docs/Web/Accessibility/AT-APIs/Gecko/Roles/ROLE_RADIO_MENU_ITEM	/ja/docs/Mozilla/Tech/Accessibility/AT-APIs/Gecko/Roles/ROLE_RADIO_MENU_ITEM
/ja/docs/Web/Accessibility/AT-APIs/Gecko/Roles/ROLE_REDUNDANT_OBJECT	/ja/docs/Mozilla/Tech/Accessibility/AT-APIs/Gecko/Roles/ROLE_REDUNDANT_OBJECT
/ja/docs/Web/Accessibility/AT-APIs/Gecko/Roles/ROLE_RICH_OPTION	/ja/docs/Mozilla/Tech/Accessibility/AT-APIs/Gecko/Roles/ROLE_RICH_OPTION
/ja/docs/Web/Accessibility/AT-APIs/Gecko/Roles/ROLE_ROOT_PANE	/ja/docs/Mozilla/Tech/Accessibility/AT-APIs/Gecko/Roles/ROLE_ROOT_PANE
/ja/docs/Web/Accessibility/AT-APIs/Gecko/Roles/ROLE_ROW	/ja/docs/Mozilla/Tech/Accessibility/AT-APIs/Gecko/Roles/ROLE_ROW
/ja/docs/Web/Accessibility/AT-APIs/Gecko/Roles/ROLE_RULER	/ja/docs/Mozilla/Tech/Accessibility/AT-APIs/Gecko/Roles/ROLE_RULER
/ja/docs/Web/Accessibility/AT-APIs/Gecko/Roles/ROLE_SCROLLBAR	/ja/docs/Mozilla/Tech/Accessibility/AT-APIs/Gecko/Roles/ROLE_SCROLLBAR
/ja/docs/Web/Accessibility/AT-APIs/Gecko/Roles/ROLE_SCROLL_PANE	/ja/docs/Mozilla/Tech/Accessibility/AT-APIs/Gecko/Roles/ROLE_SCROLL_PANE
/ja/docs/Web/Accessibility/AT-APIs/Gecko/Roles/ROLE_SECTION	/ja/docs/Mozilla/Tech/Accessibility/AT-APIs/Gecko/Roles/ROLE_SECTION
/ja/docs/Web/Accessibility/AT-APIs/Gecko/Roles/ROLE_SEPARATOR	/ja/docs/Mozilla/Tech/Accessibility/AT-APIs/Gecko/Roles/ROLE_SEPARATOR
/ja/docs/Web/Accessibility/AT-APIs/Gecko/Roles/ROLE_SLIDER	/ja/docs/Mozilla/Tech/Accessibility/AT-APIs/Gecko/Roles/ROLE_SLIDER
/ja/docs/Web/Accessibility/AT-APIs/Gecko/Roles/ROLE_SOUND	/ja/docs/Mozilla/Tech/Accessibility/AT-APIs/Gecko/Roles/ROLE_SOUND
/ja/docs/Web/Accessibility/AT-APIs/Gecko/Roles/ROLE_SPINBUTTON	/ja/docs/Mozilla/Tech/Accessibility/AT-APIs/Gecko/Roles/ROLE_SPINBUTTON
/ja/docs/Web/Accessibility/AT-APIs/Gecko/Roles/ROLE_SPLIT_PANE	/ja/docs/Mozilla/Tech/Accessibility/AT-APIs/Gecko/Roles/ROLE_SPLIT_PANE
/ja/docs/Web/Accessibility/AT-APIs/Gecko/Roles/ROLE_STATUSBAR	/ja/docs/Mozilla/Tech/Accessibility/AT-APIs/Gecko/Roles/ROLE_STATUSBAR
/ja/docs/Web/Accessibility/AT-APIs/Gecko/Roles/ROLE_TABLE	/ja/docs/Mozilla/Tech/Accessibility/AT-APIs/Gecko/Roles/ROLE_TABLE
/ja/docs/Web/Accessibility/AT-APIs/Gecko/Roles/ROLE_TABLE_COLUMN_HEADER	/ja/docs/Mozilla/Tech/Accessibility/AT-APIs/Gecko/Roles/ROLE_TABLE_COLUMN_HEADER
/ja/docs/Web/Accessibility/AT-APIs/Gecko/Roles/ROLE_TABLE_ROW_HEADER	/ja/docs/Mozilla/Tech/Accessibility/AT-APIs/Gecko/Roles/ROLE_TABLE_ROW_HEADER
/ja/docs/Web/Accessibility/AT-APIs/Gecko/Roles/ROLE_TEAR_OFF_MENU_ITEM	/ja/docs/Mozilla/Tech/Accessibility/AT-APIs/Gecko/Roles/ROLE_TEAR_OFF_MENU_ITEM
/ja/docs/Web/Accessibility/AT-APIs/Gecko/Roles/ROLE_TERMINAL	/ja/docs/Mozilla/Tech/Accessibility/AT-APIs/Gecko/Roles/ROLE_TERMINAL
/ja/docs/Web/Accessibility/AT-APIs/Gecko/Roles/ROLE_TEXT_LEAF	/ja/docs/Mozilla/Tech/Accessibility/AT-APIs/Gecko/Roles/ROLE_TEXT_LEAF
/ja/docs/Web/Accessibility/AT-APIs/Gecko/Roles/ROLE_TITLEBAR	/ja/docs/Mozilla/Tech/Accessibility/AT-APIs/Gecko/Roles/ROLE_TITLEBAR
/ja/docs/Web/Accessibility/AT-APIs/Gecko/Roles/ROLE_TOGGLE_BUTTON	/ja/docs/Mozilla/Tech/Accessibility/AT-APIs/Gecko/Roles/ROLE_TOGGLE_BUTTON
/ja/docs/Web/Accessibility/AT-APIs/Gecko/Roles/ROLE_TOOLBAR	/ja/docs/Mozilla/Tech/Accessibility/AT-APIs/Gecko/Roles/ROLE_TOOLBAR
/ja/docs/Web/Accessibility/AT-APIs/Gecko/Roles/ROLE_TOOLTIP	/ja/docs/Mozilla/Tech/Accessibility/AT-APIs/Gecko/Roles/ROLE_TOOLTIP
/ja/docs/Web/Accessibility/AT-APIs/Gecko/Roles/ROLE_TREE_TABLE	/ja/docs/Mozilla/Tech/Accessibility/AT-APIs/Gecko/Roles/ROLE_TREE_TABLE
/ja/docs/Web/Accessibility/AT-APIs/Gecko/Roles/ROLE_VIEWPORT	/ja/docs/Mozilla/Tech/Accessibility/AT-APIs/Gecko/Roles/ROLE_VIEWPORT
/ja/docs/Web/Accessibility/AT-APIs/Gecko/Roles/ROLE_WHITESPACE	/ja/docs/Mozilla/Tech/Accessibility/AT-APIs/Gecko/Roles/ROLE_WHITESPACE
/ja/docs/Web/Accessibility/AT-APIs/Gecko/Roles/ROLE_WINDOW	/ja/docs/Mozilla/Tech/Accessibility/AT-APIs/Gecko/Roles/ROLE_WINDOW
/ja/docs/Web/Apps/Advanced_topics	/ja/docs/Archive/Apps/Advanced_topics
/ja/docs/Web/Apps/Quickstart/Build	/ja/docs/Archive/B2G_OS/Quickstart
/ja/docs/Web/Apps/Quickstart/Build/初めてのアプリ	/ja/docs/Archive/B2G_OS/Quickstart/初めてのアプリ
/ja/docs/Web/CSS/:-moz-system-metric	/ja/docs/Archive/Web/CSS/:-moz-system-metric
/ja/docs/Web/CSS/:-moz-system-metric(images-in-menus)	/ja/docs/Archive/Web/CSS/:-moz-system-metric/images-in-menus
/ja/docs/Web/CSS/:-moz-system-metric(windows-default-theme)	/ja/docs/Archive/Web/CSS/:-moz-system-metric/windows-default-theme
/ja/docs/Web/CSS/:-moz-system-metric/mac-graphite-theme	/ja/docs/Archive/Web/CSS/:-moz-system-metric/mac-graphite-theme
/ja/docs/Web/CSS/:-moz-tree-cell	/ja/docs/Mozilla/Gecko/Chrome/CSS/::-moz-tree-cell
/ja/docs/Web/CSS/:-moz-tree-cell-text	/ja/docs/Mozilla/Gecko/Chrome/CSS/::-moz-tree-cell-text
/ja/docs/Web/CSS/:-moz-tree-cell-text(hover)	/ja/docs/Mozilla/Gecko/Chrome/CSS/::-moz-tree-cell-text(hover)
/ja/docs/Web/CSS/:-moz-tree-column	/ja/docs/Mozilla/Gecko/Chrome/CSS/::-moz-tree-column
/ja/docs/Web/CSS/:-moz-tree-drop-feedback	/ja/docs/Mozilla/Gecko/Chrome/CSS/::-moz-tree-drop-feedback
/ja/docs/Web/CSS/:-moz-tree-image	/ja/docs/Mozilla/Gecko/Chrome/CSS/::-moz-tree-image
/ja/docs/Web/CSS/:-moz-tree-indentation	/ja/docs/Mozilla/Gecko/Chrome/CSS/::-moz-tree-indentation
/ja/docs/Web/CSS/:-moz-tree-line	/ja/docs/Mozilla/Gecko/Chrome/CSS/::-moz-tree-line
/ja/docs/Web/CSS/:-moz-tree-progressmeter	/ja/docs/Mozilla/Gecko/Chrome/CSS/::-moz-tree-progressmeter
/ja/docs/Web/CSS/:-moz-tree-row	/ja/docs/Mozilla/Gecko/Chrome/CSS/::-moz-tree-row
/ja/docs/Web/CSS/:-moz-tree-row(hover)	/ja/docs/Mozilla/Gecko/Chrome/CSS/::-moz-tree-row(hover)
/ja/docs/Web/CSS/:-moz-tree-separator	/ja/docs/Mozilla/Gecko/Chrome/CSS/::-moz-tree-separator
/ja/docs/Web/CSS/:-moz-tree-twisty	/ja/docs/Mozilla/Gecko/Chrome/CSS/::-moz-tree-twisty
/ja/docs/Web/CSS/::-ms-clear	/ja/docs/Archive/Web/CSS/::-ms-clear
/ja/docs/Web/CSS/@media/-moz-windows-compositor	/ja/docs/Archive/Web/CSS/:-moz-system-metric/-moz-windows-compositor
/ja/docs/Web/CSS/CSS3	/ja/docs/Archive/CSS3
/ja/docs/Web/Events/CheckboxStateChange	/ja/docs/Archive/Mozilla/XUL/Events/CheckboxStateChange
/ja/docs/Web/JavaScript/Microsoft_Extensions	/ja/docs/Archive/Web/JavaScript/Microsoft_Extensions
/ja/docs/Web/JavaScript/New_in_JavaScript/ECMAScript_7_support_in_Mozilla	/ja/docs/Archive/Web/JavaScript/ECMAScript_7_support_in_Mozilla
/ja/docs/Web/JavaScript/Reference/Global_Objects/Date/toLocaleFormat	/ja/docs/Archive/Web/JavaScript/Date.toLocaleFormat
/ja/docs/Web/JavaScript/Reference/Global_Objects/Function/arity	/ja/docs/Archive/Web/JavaScript/Function.arity
/ja/docs/Web/JavaScript/Reference/Global_Objects/Function/isGenerator	/ja/docs/Archive/Web/JavaScript/Function.isGenerator
/ja/docs/Web/JavaScript/Reference/Global_Objects/Number/toInteger	/ja/docs/Archive/Web/JavaScript/Number.toInteger
/ja/docs/Web/JavaScript/Reference/Global_Objects/Object/Parent	/ja/docs/Archive/Web/JavaScript/Object.parent
/ja/docs/Web/JavaScript/Reference/Global_Objects/Object/__noSuchMethod__	/ja/docs/Archive/Web/JavaScript/Object.noSuchMethod
/ja/docs/Web/JavaScript/Reference/Global_Objects/Object/eval	/ja/docs/Archive/Web/JavaScript/Object.eval
/ja/docs/Web/JavaScript/Reference/Global_Objects/Object/getNotifier	/ja/docs/Archive/Web/JavaScript/Object.getNotifier
/ja/docs/Web/JavaScript/Reference/Global_Objects/Object/noSuchMethod	/ja/docs/Archive/Web/JavaScript/Object.noSuchMethod
/ja/docs/Web/JavaScript/Reference/Global_Objects/Object/observe	/ja/docs/Archive/Web/JavaScript/Object.observe
/ja/docs/Web/JavaScript/Reference/Global_Objects/Object/unobserve	/ja/docs/Archive/Web/JavaScript/Object.unobserve
/ja/docs/Web/JavaScript/Reference/Global_Objects/Object/unwatch	/ja/docs/Archive/Web/JavaScript/Object.unwatch
/ja/docs/Web/JavaScript/Reference/Global_Objects/Object/watch	/ja/docs/Archive/Web/JavaScript/Object.watch
/ja/docs/Web/JavaScript/Reference/Global_Objects/Proxy/handler/enumerate	/ja/docs/Archive/Web/JavaScript/handler.enumerate
/ja/docs/Web/JavaScript/Reference/Global_Objects/Reflect/enumerate	/ja/docs/Archive/Web/JavaScript/Reflect.enumerate
/ja/docs/Web/JavaScript/Reference/Operators/Legacy_generator_function	/ja/docs/Archive/Web/JavaScript/Legacy_generator_function
/ja/docs/Web/JavaScript/Reference/Statements/Legacy_generator_function	/ja/docs/Archive/Web/JavaScript/Legacy_generator_function_statement
/ja/docs/Web/Localization	/ja/docs/Archive/Web/Localization
/ja/docs/Web/Security/Information_Security_Basics/Confidentiality,_Integrity,_and_Availability	/ja/docs/Archive/Security/Confidentiality,_Integrity,_and_Availability
/ja/docs/Web/Security/Information_Security_Basics/Threats	/ja/docs/Archive/Security/Threats
/ja/docs/Web/Security/Information_Security_Basics/Vulnerabilities	/ja/docs/Archive/Security/Vulnerabilities
/ja/docs/Web_Standards	/ja/docs/Archive/Web_Standards
/ja/docs/Web_Standards/Community	/ja/docs/Archive/Web_Standards/Community
/ja/docs/Web_Standards:Community	/ja/docs/Archive/Web_Standards/Community
/ja/docs/Why_Support_Mozilla	/ja/docs/Archive/Web_Standards/Why_Support_Mozilla
/ja/docs/Window_icons	/ja/docs/Archive/Mozilla/XUL/Window_icons
/ja/docs/Windows_and_menus_in_XULRunner	/ja/docs/Archive/Mozilla/XULRunner/Windows_and_menus_in_XULRunner
/ja/docs/Working_around_the_Firefox_1.0.3_DHTML_regression	/ja/docs/Archive/Mozilla/Working_around_the_Firefox_1.0.3_DHTML_regression
/ja/docs/Working_with_windows_in_chrome_code	/ja/docs/Mozilla/Working_with_windows_in_chrome_code
/ja/docs/Writing_Skinnable_XUL_and_CSS	/ja/docs/Archive/Mozilla/XUL/Writing_Skinnable_XUL_and_CSS
/ja/docs/Writing_textual_data	/ja/docs/Archive/Mozilla/Writing_textual_data
/ja/docs/XBL	/ja/docs/Archive/Mozilla/XBL
/ja/docs/XBL/XBL_1.0_Reference	/ja/docs/Archive/Mozilla/XBL/XBL_1.0_Reference
/ja/docs/XBL/XBL_1.0_Reference/Anonymous_Content	/ja/docs/Archive/Mozilla/XBL/XBL_1.0_Reference/Anonymous_Content
/ja/docs/XBL/XBL_1.0_Reference/Binding_Attachment_and_Detachment	/ja/docs/Archive/Mozilla/XBL/XBL_1.0_Reference/Binding_Attachment_and_Detachment
/ja/docs/XBL/XBL_1.0_Reference/Binding_Implementations	/ja/docs/Archive/Mozilla/XBL/XBL_1.0_Reference/Binding_Implementations
/ja/docs/XBL/XBL_1.0_Reference/DOM_Interfaces	/ja/docs/Archive/Mozilla/XBL/XBL_1.0_Reference/DOM_Interfaces
/ja/docs/XBL/XBL_1.0_Reference/Elements	/ja/docs/Archive/Mozilla/XBL/XBL_1.0_Reference/Elements
/ja/docs/XBL/XBL_1.0_Reference/Event_Handlers	/ja/docs/Archive/Mozilla/XBL/XBL_1.0_Reference/Event_Handlers
/ja/docs/XBL/XBL_1.0_Reference/Example_Sticky_Notes	/ja/docs/Archive/Mozilla/XBL/XBL_1.0_Reference/Example_Sticky_Notes
/ja/docs/XBL:XBL_1.0_Reference	/ja/docs/Archive/Mozilla/XBL/XBL_1.0_Reference
/ja/docs/XBL:XBL_1.0_Reference:Anonymous_Content	/ja/docs/Archive/Mozilla/XBL/XBL_1.0_Reference/Anonymous_Content
/ja/docs/XBL:XBL_1.0_Reference:Binding_Attachment_and_Detachment	/ja/docs/Archive/Mozilla/XBL/XBL_1.0_Reference/Binding_Attachment_and_Detachment
/ja/docs/XBL:XBL_1.0_Reference:Binding_Implementations	/ja/docs/Archive/Mozilla/XBL/XBL_1.0_Reference/Binding_Implementations
/ja/docs/XBL:XBL_1.0_Reference:DOM_Interfaces	/ja/docs/Archive/Mozilla/XBL/XBL_1.0_Reference/DOM_Interfaces
/ja/docs/XBL:XBL_1.0_Reference:Elements	/ja/docs/Archive/Mozilla/XBL/XBL_1.0_Reference/Elements
/ja/docs/XBL:XBL_1.0_Reference:Event_Handlers	/ja/docs/Archive/Mozilla/XBL/XBL_1.0_Reference/Event_Handlers
/ja/docs/XBL:XBL_1.0_Reference:Example_Sticky_Notes	/ja/docs/Archive/Mozilla/XBL/XBL_1.0_Reference/Example_Sticky_Notes
/ja/docs/XPCOM	/ja/docs/Mozilla/Tech/XPCOM
/ja/docs/XPCOM/Guide	/ja/docs/Mozilla/Tech/XPCOM/Guide
/ja/docs/XPCOM/Guide/How_to_Build_an_XPCOM_Component_in_Javascript	/ja/docs/Mozilla/Tech/XPCOM/Guide/How_to_Build_an_XPCOM_Component_in_Javascript
/ja/docs/XPCOM/Guide/Mozilla_internal_string_guide	/ja/docs/Mozilla/Tech/XPCOM/Guide/Mozilla_internal_string_guide
/ja/docs/XPCOM/Guide/XPCOM_hashtable_guide	/ja/docs/Mozilla/Tech/XPCOM/Guide/XPCOM_hashtable_guide
/ja/docs/XPCOM/Language_Bindings	/ja/docs/Mozilla/Tech/XPCOM/Language_Bindings
/ja/docs/XPCOM/Language_Bindings/Components.utils.import	/ja/docs/Mozilla/Tech/XPCOM/Language_Bindings/Components.utils.import
/ja/docs/XPCOM/Reference	/ja/docs/Mozilla/Tech/XPCOM/Reference
/ja/docs/XPCOM/Reference/Components	/ja/docs/Mozilla/Tech/XPCOM/Reference/Components
/ja/docs/XPCOM/Reference/Components/nsCategoryManager	/ja/docs/Mozilla/Tech/XPCOM/Reference/Components/nsCategoryManager
/ja/docs/XPCOM/Reference/Components/nsDirectoryService	/ja/docs/Mozilla/Tech/XPCOM/Reference/Components/nsDirectoryService
/ja/docs/XPCOM/Reference/Components/nsLocalFile	/ja/docs/Mozilla/Tech/XPCOM/Reference/Components/nsLocalFile
/ja/docs/XPCOM/Reference/Components/nsObserverService	/ja/docs/Mozilla/Tech/XPCOM/Reference/Components/nsObserverService
/ja/docs/XPCOM/Reference/Components/nsScriptableInputStream	/ja/docs/Mozilla/Tech/XPCOM/Reference/Components/nsScriptableInputStream
/ja/docs/XPCOM/Reference/Glue_classes	/ja/docs/Mozilla/Tech/XPCOM/Reference/Glue_classes
/ja/docs/XPCOM/Reference/Glue_classes/nsCOMPtr	/ja/docs/Mozilla/Tech/XPCOM/Reference/Glue_classes/nsCOMPtr
/ja/docs/XPCOM/Reference/NS_ENSURE_TRUE	/ja/docs/Mozilla/Tech/XPCOM/Reference/NS_ENSURE_TRUE
/ja/docs/XPCOM/Reference/XPCOM_Interface_Reference	/ja/docs/Mozilla/Tech/XPCOM/Reference/XPCOM_Interface_Reference
/ja/docs/XPCOM/Reference/XPCOM_Interface_Reference/NsIDOMHTMLMediaElement	/ja/docs/Mozilla/Tech/XPCOM/Reference/XPCOM_Interface_Reference/NsIDOMHTMLMediaElement
/ja/docs/XPCOM/Reference/XPCOM_Interface_Reference/NsIDOMSimpleGestureEvent	/ja/docs/Mozilla/Tech/XPCOM/Reference/XPCOM_Interface_Reference/NsIDOMSimpleGestureEvent
/ja/docs/XPCOM/Reference/XPCOM_Interface_Reference/NsIPlacesView	/ja/docs/Mozilla/Tech/XPCOM/Reference/XPCOM_Interface_Reference/NsIPlacesView
/ja/docs/XPCOM/Reference/XPCOM_Interface_Reference/imgILoader	/ja/docs/Mozilla/Tech/XPCOM/Reference/XPCOM_Interface_Reference/imgILoader
/ja/docs/XPCOM/Reference/XPCOM_Interface_Reference/mozIJSSubScriptLoader	/ja/docs/Mozilla/Tech/XPCOM/Reference/XPCOM_Interface_Reference/mozIJSSubScriptLoader
/ja/docs/XPCOM/Reference/XPCOM_Interface_Reference/mozIRegistry	/ja/docs/Mozilla/Tech/XPCOM/Reference/XPCOM_Interface_Reference/mozIRegistry
/ja/docs/XPCOM/Reference/XPCOM_Interface_Reference/mozIStorageStatementParams	/ja/docs/Mozilla/Tech/XPCOM/Reference/XPCOM_Interface_Reference/mozIStorageStatementParams
/ja/docs/XPCOM/Reference/XPCOM_Interface_Reference/nsIAccessible	/ja/docs/Mozilla/Tech/XPCOM/Reference/XPCOM_Interface_Reference/nsIAccessible
/ja/docs/XPCOM/Reference/XPCOM_Interface_Reference/nsIAccessibleProvider	/ja/docs/Mozilla/Tech/XPCOM/Reference/XPCOM_Interface_Reference/nsIAccessibleProvider
/ja/docs/XPCOM/Reference/XPCOM_Interface_Reference/nsIAnnotationObserver	/ja/docs/Mozilla/Tech/XPCOM/Reference/XPCOM_Interface_Reference/nsIAnnotationObserver
/ja/docs/XPCOM/Reference/XPCOM_Interface_Reference/nsIAsyncInputStream	/ja/docs/Mozilla/Tech/XPCOM/Reference/XPCOM_Interface_Reference/nsIAsyncInputStream
/ja/docs/XPCOM/Reference/XPCOM_Interface_Reference/nsIConsoleService	/ja/docs/Mozilla/Tech/XPCOM/Reference/XPCOM_Interface_Reference/nsIConsoleService
/ja/docs/XPCOM/Reference/XPCOM_Interface_Reference/nsIContentPrefObserver	/ja/docs/Mozilla/Tech/XPCOM/Reference/XPCOM_Interface_Reference/nsIContentPrefObserver
/ja/docs/XPCOM/Reference/XPCOM_Interface_Reference/nsIContentPrefService	/ja/docs/Mozilla/Tech/XPCOM/Reference/XPCOM_Interface_Reference/nsIContentPrefService
/ja/docs/XPCOM/Reference/XPCOM_Interface_Reference/nsICryptoHash	/ja/docs/Mozilla/Tech/XPCOM/Reference/XPCOM_Interface_Reference/nsICryptoHash
/ja/docs/XPCOM/Reference/XPCOM_Interface_Reference/nsIDOMFile	/ja/docs/Mozilla/Tech/XPCOM/Reference/XPCOM_Interface_Reference/nsIDOMFile
/ja/docs/XPCOM/Reference/XPCOM_Interface_Reference/nsIDOMFileException	/ja/docs/Mozilla/Tech/XPCOM/Reference/XPCOM_Interface_Reference/nsIDOMFileException
/ja/docs/XPCOM/Reference/XPCOM_Interface_Reference/nsIDOMFileList	/ja/docs/Mozilla/Tech/XPCOM/Reference/XPCOM_Interface_Reference/nsIDOMFileList
/ja/docs/XPCOM/Reference/XPCOM_Interface_Reference/nsIDOMOfflineResourceList	/ja/docs/Mozilla/Tech/XPCOM/Reference/XPCOM_Interface_Reference/nsIDOMOfflineResourceList
/ja/docs/XPCOM/Reference/XPCOM_Interface_Reference/nsIDownload	/ja/docs/Mozilla/Tech/XPCOM/Reference/XPCOM_Interface_Reference/nsIDownload
/ja/docs/XPCOM/Reference/XPCOM_Interface_Reference/nsIDownloadManager	/ja/docs/Mozilla/Tech/XPCOM/Reference/XPCOM_Interface_Reference/nsIDownloadManager
/ja/docs/XPCOM/Reference/XPCOM_Interface_Reference/nsIDownloadManagerUI	/ja/docs/Mozilla/Tech/XPCOM/Reference/XPCOM_Interface_Reference/nsIDownloadManagerUI
/ja/docs/XPCOM/Reference/XPCOM_Interface_Reference/nsIDownloadProgressListener	/ja/docs/Mozilla/Tech/XPCOM/Reference/XPCOM_Interface_Reference/nsIDownloadProgressListener
/ja/docs/XPCOM/Reference/XPCOM_Interface_Reference/nsIDragService	/ja/docs/Mozilla/Tech/XPCOM/Reference/XPCOM_Interface_Reference/nsIDragService
/ja/docs/XPCOM/Reference/XPCOM_Interface_Reference/nsIEffectiveTLDService	/ja/docs/Mozilla/Tech/XPCOM/Reference/XPCOM_Interface_Reference/nsIEffectiveTLDService
/ja/docs/XPCOM/Reference/XPCOM_Interface_Reference/nsIFeed	/ja/docs/Mozilla/Tech/XPCOM/Reference/XPCOM_Interface_Reference/nsIFeed
/ja/docs/XPCOM/Reference/XPCOM_Interface_Reference/nsIFeedContainer	/ja/docs/Mozilla/Tech/XPCOM/Reference/XPCOM_Interface_Reference/nsIFeedContainer
/ja/docs/XPCOM/Reference/XPCOM_Interface_Reference/nsIFeedElementBase	/ja/docs/Mozilla/Tech/XPCOM/Reference/XPCOM_Interface_Reference/nsIFeedElementBase
/ja/docs/XPCOM/Reference/XPCOM_Interface_Reference/nsIFeedEntry	/ja/docs/Mozilla/Tech/XPCOM/Reference/XPCOM_Interface_Reference/nsIFeedEntry
/ja/docs/XPCOM/Reference/XPCOM_Interface_Reference/nsIFeedGenerator	/ja/docs/Mozilla/Tech/XPCOM/Reference/XPCOM_Interface_Reference/nsIFeedGenerator
/ja/docs/XPCOM/Reference/XPCOM_Interface_Reference/nsIFeedPerson	/ja/docs/Mozilla/Tech/XPCOM/Reference/XPCOM_Interface_Reference/nsIFeedPerson
/ja/docs/XPCOM/Reference/XPCOM_Interface_Reference/nsIFeedProcessor	/ja/docs/Mozilla/Tech/XPCOM/Reference/XPCOM_Interface_Reference/nsIFeedProcessor
/ja/docs/XPCOM/Reference/XPCOM_Interface_Reference/nsIFeedProgressListener	/ja/docs/Mozilla/Tech/XPCOM/Reference/XPCOM_Interface_Reference/nsIFeedProgressListener
/ja/docs/XPCOM/Reference/XPCOM_Interface_Reference/nsIFeedResult	/ja/docs/Mozilla/Tech/XPCOM/Reference/XPCOM_Interface_Reference/nsIFeedResult
/ja/docs/XPCOM/Reference/XPCOM_Interface_Reference/nsIFeedResultListener	/ja/docs/Mozilla/Tech/XPCOM/Reference/XPCOM_Interface_Reference/nsIFeedResultListener
/ja/docs/XPCOM/Reference/XPCOM_Interface_Reference/nsIFeedTextConstruct	/ja/docs/Mozilla/Tech/XPCOM/Reference/XPCOM_Interface_Reference/nsIFeedTextConstruct
/ja/docs/XPCOM/Reference/XPCOM_Interface_Reference/nsIHttpActivityDistributor	/ja/docs/Mozilla/Tech/XPCOM/Reference/XPCOM_Interface_Reference/nsIHttpActivityDistributor
/ja/docs/XPCOM/Reference/XPCOM_Interface_Reference/nsIHttpActivityObserver	/ja/docs/Mozilla/Tech/XPCOM/Reference/XPCOM_Interface_Reference/nsIHttpActivityObserver
/ja/docs/XPCOM/Reference/XPCOM_Interface_Reference/nsIHttpChannel	/ja/docs/Mozilla/Tech/XPCOM/Reference/XPCOM_Interface_Reference/nsIHttpChannel
/ja/docs/XPCOM/Reference/XPCOM_Interface_Reference/nsIIOService	/ja/docs/Mozilla/Tech/XPCOM/Reference/XPCOM_Interface_Reference/nsIIOService
/ja/docs/XPCOM/Reference/XPCOM_Interface_Reference/nsIIdleService	/ja/docs/Mozilla/Tech/XPCOM/Reference/XPCOM_Interface_Reference/nsIIdleService
/ja/docs/XPCOM/Reference/XPCOM_Interface_Reference/nsIInputStream	/ja/docs/Mozilla/Tech/XPCOM/Reference/XPCOM_Interface_Reference/nsIInputStream
/ja/docs/XPCOM/Reference/XPCOM_Interface_Reference/nsIJSCID	/ja/docs/Mozilla/Tech/XPCOM/Reference/XPCOM_Interface_Reference/nsIJSCID
/ja/docs/XPCOM/Reference/XPCOM_Interface_Reference/nsIJSON	/ja/docs/Mozilla/Tech/XPCOM/Reference/XPCOM_Interface_Reference/nsIJSON
/ja/docs/XPCOM/Reference/XPCOM_Interface_Reference/nsILoginInfo	/ja/docs/Mozilla/Tech/XPCOM/Reference/XPCOM_Interface_Reference/nsILoginInfo
/ja/docs/XPCOM/Reference/XPCOM_Interface_Reference/nsILoginManager	/ja/docs/Mozilla/Tech/XPCOM/Reference/XPCOM_Interface_Reference/nsILoginManager
/ja/docs/XPCOM/Reference/XPCOM_Interface_Reference/nsIObserver	/ja/docs/Mozilla/Tech/XPCOM/Reference/XPCOM_Interface_Reference/nsIObserver
/ja/docs/XPCOM/Reference/XPCOM_Interface_Reference/nsIObserverService	/ja/docs/Mozilla/Tech/XPCOM/Reference/XPCOM_Interface_Reference/nsIObserverService
/ja/docs/XPCOM/Reference/XPCOM_Interface_Reference/nsIOutputStream	/ja/docs/Mozilla/Tech/XPCOM/Reference/XPCOM_Interface_Reference/nsIOutputStream
/ja/docs/XPCOM/Reference/XPCOM_Interface_Reference/nsIParentalControlsService	/ja/docs/Mozilla/Tech/XPCOM/Reference/XPCOM_Interface_Reference/nsIParentalControlsService
/ja/docs/XPCOM/Reference/XPCOM_Interface_Reference/nsIParserUtils	/ja/docs/Mozilla/Tech/XPCOM/Reference/XPCOM_Interface_Reference/nsIParserUtils
/ja/docs/XPCOM/Reference/XPCOM_Interface_Reference/nsIPassword	/ja/docs/Mozilla/Tech/XPCOM/Reference/XPCOM_Interface_Reference/nsIPassword
/ja/docs/XPCOM/Reference/XPCOM_Interface_Reference/nsIPasswordManager	/ja/docs/Mozilla/Tech/XPCOM/Reference/XPCOM_Interface_Reference/nsIPasswordManager
/ja/docs/XPCOM/Reference/XPCOM_Interface_Reference/nsIPrefBranch	/ja/docs/Mozilla/Tech/XPCOM/Reference/XPCOM_Interface_Reference/nsIPrefBranch
/ja/docs/XPCOM/Reference/XPCOM_Interface_Reference/nsIScriptableUnescapeHTML	/ja/docs/Mozilla/Tech/XPCOM/Reference/XPCOM_Interface_Reference/nsIScriptableUnescapeHTML
/ja/docs/XPCOM/Reference/XPCOM_Interface_Reference/nsIScriptableUnicodeConverter	/ja/docs/Mozilla/Tech/XPCOM/Reference/XPCOM_Interface_Reference/nsIScriptableUnicodeConverter
/ja/docs/XPCOM/Reference/XPCOM_Interface_Reference/nsISessionStore	/ja/docs/Mozilla/Tech/XPCOM/Reference/XPCOM_Interface_Reference/nsISessionStore
/ja/docs/XPCOM/Reference/XPCOM_Interface_Reference/nsISupports_proxies	/ja/docs/Mozilla/Tech/XPCOM/Reference/XPCOM_Interface_Reference/nsISupports_proxies
/ja/docs/XPCOM/Reference/XPCOM_Interface_Reference/nsITaggingService	/ja/docs/Mozilla/Tech/XPCOM/Reference/XPCOM_Interface_Reference/nsITaggingService
/ja/docs/XPCOM/Reference/XPCOM_Interface_Reference/nsIThread	/ja/docs/Mozilla/Tech/XPCOM/Reference/XPCOM_Interface_Reference/nsIThread
/ja/docs/XPCOM/Reference/XPCOM_Interface_Reference/nsIThreadEventFilter	/ja/docs/Mozilla/Tech/XPCOM/Reference/XPCOM_Interface_Reference/nsIThreadEventFilter
/ja/docs/XPCOM/Reference/XPCOM_Interface_Reference/nsIThreadInternal	/ja/docs/Mozilla/Tech/XPCOM/Reference/XPCOM_Interface_Reference/nsIThreadInternal
/ja/docs/XPCOM/Reference/XPCOM_Interface_Reference/nsIThreadManager	/ja/docs/Mozilla/Tech/XPCOM/Reference/XPCOM_Interface_Reference/nsIThreadManager
/ja/docs/XPCOM/Reference/XPCOM_Interface_Reference/nsIThreadObserver	/ja/docs/Mozilla/Tech/XPCOM/Reference/XPCOM_Interface_Reference/nsIThreadObserver
/ja/docs/XPCOM/Reference/XPCOM_Interface_Reference/nsIThreadPool	/ja/docs/Mozilla/Tech/XPCOM/Reference/XPCOM_Interface_Reference/nsIThreadPool
/ja/docs/XPCOM/Reference/XPCOM_Interface_Reference/nsIWebProgressListener	/ja/docs/Mozilla/Tech/XPCOM/Reference/XPCOM_Interface_Reference/nsIWebProgressListener
/ja/docs/XPCOM/Reference/XPCOM_Interface_Reference/nsIWindowMediator	/ja/docs/Mozilla/Tech/XPCOM/Reference/XPCOM_Interface_Reference/nsIWindowMediator
/ja/docs/XPCOM/Reference/XPCOM_Interface_Reference/nsIXMLHttpRequest	/ja/docs/Mozilla/Tech/XPCOM/Reference/XPCOM_Interface_Reference/nsIXMLHttpRequest
/ja/docs/XPCOM/Reference/XPCOM_Interface_Reference/nsIZipEntry	/ja/docs/Mozilla/Tech/XPCOM/Reference/XPCOM_Interface_Reference/nsIZipEntry
/ja/docs/XPCOM/Reference/XPCOM_Interface_Reference/nsIZipReader	/ja/docs/Mozilla/Tech/XPCOM/Reference/XPCOM_Interface_Reference/nsIZipReader
/ja/docs/XPCOM/Reference/XPCOM_Interface_Reference/nsIZipWriter	/ja/docs/Mozilla/Tech/XPCOM/Reference/XPCOM_Interface_Reference/nsIZipWriter
/ja/docs/XPCOM/Reference/XPCOM_Interface_Reference_group	/ja/docs/Mozilla/Tech/XPCOM/Reference/XPCOM_Interface_Reference_group
/ja/docs/XPCOM/Setting_HTTP_request_headers	/ja/docs/Mozilla/Tech/XPCOM/Setting_HTTP_request_headers
/ja/docs/XPCOM/The_Thread_Manager	/ja/docs/Mozilla/Tech/XPCOM/The_Thread_Manager
/ja/docs/XPCOM/wrappedJSObject	/ja/docs/Mozilla/Tech/XPCOM/wrappedJSObject
/ja/docs/XPCOM_ABI	/ja/docs/Mozilla/Tech/XPCOM/XPCOM_ABI
/ja/docs/XPCOM_API_Reference	/ja/docs/Mozilla/Tech/XPCOM/Reference
/ja/docs/XPCOM_Interface_Reference	/ja/docs/Mozilla/Tech/XPCOM/Reference/XPCOM_Interface_Reference
/ja/docs/XPCOM_Interface_Reference/NsIDOMHTMLMediaElement	/ja/docs/Mozilla/Tech/XPCOM/Reference/XPCOM_Interface_Reference/NsIDOMHTMLMediaElement
/ja/docs/XPCOM_Interface_Reference/imgILoader	/ja/docs/Mozilla/Tech/XPCOM/Reference/XPCOM_Interface_Reference/imgILoader
/ja/docs/XPCOM_Interface_Reference/mozIJSSubScriptLoader	/ja/docs/Mozilla/Tech/XPCOM/Reference/XPCOM_Interface_Reference/mozIJSSubScriptLoader
/ja/docs/XPCOM_Interface_Reference/nsIAccessibleProvider	/ja/docs/Mozilla/Tech/XPCOM/Reference/XPCOM_Interface_Reference/nsIAccessibleProvider
/ja/docs/XPCOM_Interface_Reference/nsIAsyncInputStream	/ja/docs/Mozilla/Tech/XPCOM/Reference/XPCOM_Interface_Reference/nsIAsyncInputStream
/ja/docs/XPCOM_Interface_Reference/nsIConsoleService	/ja/docs/Mozilla/Tech/XPCOM/Reference/XPCOM_Interface_Reference/nsIConsoleService
/ja/docs/XPCOM_Interface_Reference/nsIContentPrefObserver	/ja/docs/Mozilla/Tech/XPCOM/Reference/XPCOM_Interface_Reference/nsIContentPrefObserver
/ja/docs/XPCOM_Interface_Reference/nsIContentPrefService	/ja/docs/Mozilla/Tech/XPCOM/Reference/XPCOM_Interface_Reference/nsIContentPrefService
/ja/docs/XPCOM_Interface_Reference/nsICryptoHash	/ja/docs/Mozilla/Tech/XPCOM/Reference/XPCOM_Interface_Reference/nsICryptoHash
/ja/docs/XPCOM_Interface_Reference/nsIDownload	/ja/docs/Mozilla/Tech/XPCOM/Reference/XPCOM_Interface_Reference/nsIDownload
/ja/docs/XPCOM_Interface_Reference/nsIDownloadManager	/ja/docs/Mozilla/Tech/XPCOM/Reference/XPCOM_Interface_Reference/nsIDownloadManager
/ja/docs/XPCOM_Interface_Reference/nsIDownloadManagerUI	/ja/docs/Mozilla/Tech/XPCOM/Reference/XPCOM_Interface_Reference/nsIDownloadManagerUI
/ja/docs/XPCOM_Interface_Reference/nsIDownloadProgressListener	/ja/docs/Mozilla/Tech/XPCOM/Reference/XPCOM_Interface_Reference/nsIDownloadProgressListener
/ja/docs/XPCOM_Interface_Reference/nsIDragService	/ja/docs/Mozilla/Tech/XPCOM/Reference/XPCOM_Interface_Reference/nsIDragService
/ja/docs/XPCOM_Interface_Reference/nsIFeed	/ja/docs/Mozilla/Tech/XPCOM/Reference/XPCOM_Interface_Reference/nsIFeed
/ja/docs/XPCOM_Interface_Reference/nsIFeedContainer	/ja/docs/Mozilla/Tech/XPCOM/Reference/XPCOM_Interface_Reference/nsIFeedContainer
/ja/docs/XPCOM_Interface_Reference/nsIFeedElementBase	/ja/docs/Mozilla/Tech/XPCOM/Reference/XPCOM_Interface_Reference/nsIFeedElementBase
/ja/docs/XPCOM_Interface_Reference/nsIFeedEntry	/ja/docs/Mozilla/Tech/XPCOM/Reference/XPCOM_Interface_Reference/nsIFeedEntry
/ja/docs/XPCOM_Interface_Reference/nsIFeedGenerator	/ja/docs/Mozilla/Tech/XPCOM/Reference/XPCOM_Interface_Reference/nsIFeedGenerator
/ja/docs/XPCOM_Interface_Reference/nsIFeedPerson	/ja/docs/Mozilla/Tech/XPCOM/Reference/XPCOM_Interface_Reference/nsIFeedPerson
/ja/docs/XPCOM_Interface_Reference/nsIFeedProcessor	/ja/docs/Mozilla/Tech/XPCOM/Reference/XPCOM_Interface_Reference/nsIFeedProcessor
/ja/docs/XPCOM_Interface_Reference/nsIFeedProgressListener	/ja/docs/Mozilla/Tech/XPCOM/Reference/XPCOM_Interface_Reference/nsIFeedProgressListener
/ja/docs/XPCOM_Interface_Reference/nsIFeedResult	/ja/docs/Mozilla/Tech/XPCOM/Reference/XPCOM_Interface_Reference/nsIFeedResult
/ja/docs/XPCOM_Interface_Reference/nsIFeedResultListener	/ja/docs/Mozilla/Tech/XPCOM/Reference/XPCOM_Interface_Reference/nsIFeedResultListener
/ja/docs/XPCOM_Interface_Reference/nsIFeedTextConstruct	/ja/docs/Mozilla/Tech/XPCOM/Reference/XPCOM_Interface_Reference/nsIFeedTextConstruct
/ja/docs/XPCOM_Interface_Reference/nsIHttpChannel	/ja/docs/Mozilla/Tech/XPCOM/Reference/XPCOM_Interface_Reference/nsIHttpChannel
/ja/docs/XPCOM_Interface_Reference/nsIIOService	/ja/docs/Mozilla/Tech/XPCOM/Reference/XPCOM_Interface_Reference/nsIIOService
/ja/docs/XPCOM_Interface_Reference/nsIIdleService	/ja/docs/Mozilla/Tech/XPCOM/Reference/XPCOM_Interface_Reference/nsIIdleService
/ja/docs/XPCOM_Interface_Reference/nsIInputStream	/ja/docs/Mozilla/Tech/XPCOM/Reference/XPCOM_Interface_Reference/nsIInputStream
/ja/docs/XPCOM_Interface_Reference/nsIJSCID	/ja/docs/Mozilla/Tech/XPCOM/Reference/XPCOM_Interface_Reference/nsIJSCID
/ja/docs/XPCOM_Interface_Reference/nsIJSON	/ja/docs/Mozilla/Tech/XPCOM/Reference/XPCOM_Interface_Reference/nsIJSON
/ja/docs/XPCOM_Interface_Reference/nsILoginInfo	/ja/docs/Mozilla/Tech/XPCOM/Reference/XPCOM_Interface_Reference/nsILoginInfo
/ja/docs/XPCOM_Interface_Reference/nsILoginManager	/ja/docs/Mozilla/Tech/XPCOM/Reference/XPCOM_Interface_Reference/nsILoginManager
/ja/docs/XPCOM_Interface_Reference/nsIObserver	/ja/docs/Mozilla/Tech/XPCOM/Reference/XPCOM_Interface_Reference/nsIObserver
/ja/docs/XPCOM_Interface_Reference/nsIObserverService	/ja/docs/Mozilla/Tech/XPCOM/Reference/XPCOM_Interface_Reference/nsIObserverService
/ja/docs/XPCOM_Interface_Reference/nsIOutputStream	/ja/docs/Mozilla/Tech/XPCOM/Reference/XPCOM_Interface_Reference/nsIOutputStream
/ja/docs/XPCOM_Interface_Reference/nsIParentalControlsService	/ja/docs/Mozilla/Tech/XPCOM/Reference/XPCOM_Interface_Reference/nsIParentalControlsService
/ja/docs/XPCOM_Interface_Reference/nsIParserUtils	/ja/docs/Mozilla/Tech/XPCOM/Reference/XPCOM_Interface_Reference/nsIParserUtils
/ja/docs/XPCOM_Interface_Reference/nsIPrefBranch	/ja/docs/Mozilla/Tech/XPCOM/Reference/XPCOM_Interface_Reference/nsIPrefBranch
/ja/docs/XPCOM_Interface_Reference/nsIScriptableUnescapeHTML	/ja/docs/Mozilla/Tech/XPCOM/Reference/XPCOM_Interface_Reference/nsIScriptableUnescapeHTML
/ja/docs/XPCOM_Interface_Reference/nsIScriptableUnicodeConverter	/ja/docs/Mozilla/Tech/XPCOM/Reference/XPCOM_Interface_Reference/nsIScriptableUnicodeConverter
/ja/docs/XPCOM_Interface_Reference/nsISessionStore	/ja/docs/Mozilla/Tech/XPCOM/Reference/XPCOM_Interface_Reference/nsISessionStore
/ja/docs/XPCOM_Interface_Reference/nsIThread	/ja/docs/Mozilla/Tech/XPCOM/Reference/XPCOM_Interface_Reference/nsIThread
/ja/docs/XPCOM_Interface_Reference/nsIThreadEventFilter	/ja/docs/Mozilla/Tech/XPCOM/Reference/XPCOM_Interface_Reference/nsIThreadEventFilter
/ja/docs/XPCOM_Interface_Reference/nsIThreadInternal	/ja/docs/Mozilla/Tech/XPCOM/Reference/XPCOM_Interface_Reference/nsIThreadInternal
/ja/docs/XPCOM_Interface_Reference/nsIThreadManager	/ja/docs/Mozilla/Tech/XPCOM/Reference/XPCOM_Interface_Reference/nsIThreadManager
/ja/docs/XPCOM_Interface_Reference/nsIThreadObserver	/ja/docs/Mozilla/Tech/XPCOM/Reference/XPCOM_Interface_Reference/nsIThreadObserver
/ja/docs/XPCOM_Interface_Reference/nsIThreadPool	/ja/docs/Mozilla/Tech/XPCOM/Reference/XPCOM_Interface_Reference/nsIThreadPool
/ja/docs/XPCOM_Interface_Reference/nsIWebProgressListener	/ja/docs/Mozilla/Tech/XPCOM/Reference/XPCOM_Interface_Reference/nsIWebProgressListener
/ja/docs/XPCOM_Interface_Reference/nsIWindowMediator	/ja/docs/Mozilla/Tech/XPCOM/Reference/XPCOM_Interface_Reference/nsIWindowMediator
/ja/docs/XPCOM_Interface_Reference/nsIXMLHttpRequest	/ja/docs/Mozilla/Tech/XPCOM/Reference/XPCOM_Interface_Reference/nsIXMLHttpRequest
/ja/docs/XPCOM_Interface_Reference/nsIZipEntry	/ja/docs/Mozilla/Tech/XPCOM/Reference/XPCOM_Interface_Reference/nsIZipEntry
/ja/docs/XPCOM_Interface_Reference/nsIZipReader	/ja/docs/Mozilla/Tech/XPCOM/Reference/XPCOM_Interface_Reference/nsIZipReader
/ja/docs/XPCOM_Interface_Reference/nsIZipWriter	/ja/docs/Mozilla/Tech/XPCOM/Reference/XPCOM_Interface_Reference/nsIZipWriter
/ja/docs/XPCOM_Interface_Reference_group	/ja/docs/Mozilla/Tech/XPCOM/Reference/XPCOM_Interface_Reference_group
/ja/docs/XPCOM_hashtable_guide	/ja/docs/Mozilla/Tech/XPCOM/Guide/XPCOM_hashtable_guide
/ja/docs/XPCOM_ownership_guidelines	/ja/docs/Mozilla/Tech/XPCOM/XPCOM_ownership_guidelines
/ja/docs/XPCOM_string_guide	/ja/docs/Mozilla/Tech/XPCOM/Guide/Mozilla_internal_string_guide
/ja/docs/XPIDL	/ja/docs/Mozilla/Tech/XPIDL
/ja/docs/XPIDL/xpidl	/ja/docs/Mozilla/Tech/XPIDL/xpidl
/ja/docs/XPIDL:xpidl	/ja/docs/Mozilla/Tech/XPIDL/xpidl
/ja/docs/XPToolkit	/ja/docs/Archive/Mozilla/XUL
/ja/docs/autohide	/ja/docs/Archive/Mozilla/XUL/XUL:Attribute:autohide
/ja/docs/chrome.manifest	/ja/docs/Mozilla/Chrome_Registration
/ja/docs/chrome_window_icons	/ja/docs/Archive/Mozilla/XUL/Window_icons
/ja/docs/dummySlug/Reference/Global_Objects/Function/arity	/ja/docs/Archive/Web/JavaScript/Function.arity
/ja/docs/dummySlug/Reference/Global_Objects/Function/isGenerator	/ja/docs/Archive/Web/JavaScript/Function.isGenerator
/ja/docs/dummySlug/Reference/Global_Objects/Object/Parent	/ja/docs/Archive/Web/JavaScript/Object.parent
/ja/docs/dummySlug/Reference/Global_Objects/Object/eval	/ja/docs/Archive/Web/JavaScript/Object.eval
/ja/docs/dummySlug/Reference/Global_Objects/Object/noSuchMethod	/ja/docs/Archive/Web/JavaScript/Object.noSuchMethod
/ja/docs/dummySlug/Reference/Global_Objects/Object/unwatch	/ja/docs/Archive/Web/JavaScript/Object.unwatch
/ja/docs/dummySlug/Reference/Global_Objects/Object/watch	/ja/docs/Archive/Web/JavaScript/Object.watch
/ja/docs/dummySlug/Tutorial	/ja/docs/Archive/Mozilla/XUL/Tutorial
/ja/docs/dummySlug/Tutorial/Adding_Buttons	/ja/docs/Archive/Mozilla/XUL/Tutorial/Adding_Buttons
/ja/docs/dummySlug/Tutorial/Adding_Event_Handlers	/ja/docs/Archive/Mozilla/XUL/Tutorial/Adding_Event_Handlers
/ja/docs/dummySlug/Tutorial/Adding_Event_Handlers_to_XBL-defined_Elements	/ja/docs/Archive/Mozilla/XUL/Tutorial/Adding_Event_Handlers_to_XBL-defined_Elements
/ja/docs/dummySlug/Tutorial/Adding_HTML_Elements	/ja/docs/Archive/Mozilla/XUL/Tutorial/Adding_HTML_Elements
/ja/docs/dummySlug/Tutorial/Adding_Labels_and_Images	/ja/docs/Archive/Mozilla/XUL/Tutorial/Adding_Labels_and_Images
/ja/docs/dummySlug/Tutorial/Adding_Methods_to_XBL-defined_Elements	/ja/docs/Archive/Mozilla/XUL/Tutorial/Adding_Methods_to_XBL-defined_Elements
/ja/docs/dummySlug/Tutorial/Adding_More_Elements	/ja/docs/Archive/Mozilla/XUL/Tutorial/Adding_More_Elements
/ja/docs/dummySlug/Tutorial/Adding_Properties_to_XBL-defined_Elements	/ja/docs/Archive/Mozilla/XUL/Tutorial/Adding_Properties_to_XBL-defined_Elements
/ja/docs/dummySlug/Tutorial/Adding_Style_Sheets	/ja/docs/Archive/Mozilla/XUL/Tutorial/Adding_Style_Sheets
/ja/docs/dummySlug/Tutorial/Additional_Install_Features	/ja/docs/Archive/Mozilla/XUL/Tutorial/Additional_Install_Features
/ja/docs/dummySlug/Tutorial/Advanced_Rules	/ja/docs/Archive/Mozilla/XUL/Tutorial/Advanced_Rules
/ja/docs/dummySlug/Tutorial/Anonymous_Content	/ja/docs/Archive/Mozilla/XUL/Tutorial/Anonymous_Content
/ja/docs/dummySlug/Tutorial/Box_Model_Details	/ja/docs/Archive/Mozilla/XUL/Tutorial/Box_Model_Details
/ja/docs/dummySlug/Tutorial/Box_Objects	/ja/docs/Archive/Mozilla/XUL/Tutorial/Box_Objects
/ja/docs/dummySlug/Tutorial/Broadcasters_and_Observers	/ja/docs/Archive/Mozilla/XUL/Tutorial/Broadcasters_and_Observers
/ja/docs/dummySlug/Tutorial/Commands	/ja/docs/Archive/Mozilla/XUL/Tutorial/Commands
/ja/docs/dummySlug/Tutorial/Content_Panels	/ja/docs/Archive/Mozilla/XUL/Tutorial/Content_Panels
/ja/docs/dummySlug/Tutorial/Creating_Dialogs	/ja/docs/Archive/Mozilla/XUL/Tutorial/Creating_Dialogs
/ja/docs/dummySlug/Tutorial/Creating_a_Skin	/ja/docs/Archive/Mozilla/XUL/Tutorial/Creating_a_Skin
/ja/docs/dummySlug/Tutorial/Creating_a_Window	/ja/docs/Archive/Mozilla/XUL/Tutorial/Creating_a_Window
/ja/docs/dummySlug/Tutorial/Creating_a_Wizard	/ja/docs/Archive/Mozilla/XUL/Tutorial/Creating_a_Wizard
/ja/docs/dummySlug/Tutorial/Creating_an_Installer	/ja/docs/Archive/Mozilla/XUL/Tutorial/Creating_an_Installer
/ja/docs/dummySlug/Tutorial/Cross_Package_Overlays	/ja/docs/Archive/Mozilla/XUL/Tutorial/Cross_Package_Overlays
/ja/docs/dummySlug/Tutorial/Custom_Tree_Views	/ja/docs/Archive/Mozilla/XUL/Tutorial/Custom_Tree_Views
/ja/docs/dummySlug/Tutorial/Document_Object_Model	/ja/docs/Archive/Mozilla/XUL/Tutorial/Document_Object_Model
/ja/docs/dummySlug/Tutorial/Element_Positioning	/ja/docs/Archive/Mozilla/XUL/Tutorial/Element_Positioning
/ja/docs/dummySlug/Tutorial/Features_of_a_Window	/ja/docs/Archive/Mozilla/XUL/Tutorial/Features_of_a_Window
/ja/docs/dummySlug/Tutorial/Focus_and_Selection	/ja/docs/Archive/Mozilla/XUL/Tutorial/Focus_and_Selection
/ja/docs/dummySlug/Tutorial/Grids	/ja/docs/Archive/Mozilla/XUL/Tutorial/Grids
/ja/docs/dummySlug/Tutorial/Groupboxes	/ja/docs/Archive/Mozilla/XUL/Tutorial/Groupboxes
/ja/docs/dummySlug/Tutorial/Input_Controls	/ja/docs/Archive/Mozilla/XUL/Tutorial/Input_Controls
/ja/docs/dummySlug/Tutorial/Install_Scripts	/ja/docs/Archive/Mozilla/XUL/Tutorial/Install_Scripts
/ja/docs/dummySlug/Tutorial/Introduction	/ja/docs/Archive/Mozilla/XUL/Tutorial/Introduction
/ja/docs/dummySlug/Tutorial/Introduction_to_RDF	/ja/docs/Archive/Mozilla/XUL/Tutorial/Introduction_to_RDF
/ja/docs/dummySlug/Tutorial/Introduction_to_XBL	/ja/docs/Archive/Mozilla/XUL/Tutorial/Introduction_to_XBL
/ja/docs/dummySlug/Tutorial/Keyboard_Shortcuts	/ja/docs/Archive/Mozilla/XUL/Tutorial/Keyboard_Shortcuts
/ja/docs/dummySlug/Tutorial/List_Controls	/ja/docs/Archive/Mozilla/XUL/Tutorial/List_Controls
/ja/docs/dummySlug/Tutorial/Localization	/ja/docs/Archive/Mozilla/XUL/Tutorial/Localization
/ja/docs/dummySlug/Tutorial/Manifest_Files	/ja/docs/Archive/Mozilla/XUL/Tutorial/Manifest_Files
/ja/docs/dummySlug/Tutorial/Manipulating_Lists	/ja/docs/Archive/Mozilla/XUL/Tutorial/Manipulating_Lists
/ja/docs/dummySlug/Tutorial/Modifying_a_XUL_Interface	/ja/docs/Archive/Mozilla/XUL/Tutorial/Modifying_a_XUL_Interface
/ja/docs/dummySlug/Tutorial/Modifying_the_Default_Skin	/ja/docs/Archive/Mozilla/XUL/Tutorial/Modifying_the_Default_Skin
/ja/docs/dummySlug/Tutorial/More_Button_Features	/ja/docs/Archive/Mozilla/XUL/Tutorial/More_Button_Features
/ja/docs/dummySlug/Tutorial/More_Event_Handlers	/ja/docs/Archive/Mozilla/XUL/Tutorial/More_Event_Handlers
/ja/docs/dummySlug/Tutorial/More_Menu_Features	/ja/docs/Archive/Mozilla/XUL/Tutorial/More_Menu_Features
/ja/docs/dummySlug/Tutorial/More_Tree_Features	/ja/docs/Archive/Mozilla/XUL/Tutorial/More_Tree_Features
/ja/docs/dummySlug/Tutorial/More_Wizards	/ja/docs/Archive/Mozilla/XUL/Tutorial/More_Wizards
/ja/docs/dummySlug/Tutorial/Numeric_Controls	/ja/docs/Archive/Mozilla/XUL/Tutorial/Numeric_Controls
/ja/docs/dummySlug/Tutorial/Open_and_Save_Dialogs	/ja/docs/Archive/Mozilla/XUL/Tutorial/Open_and_Save_Dialogs
/ja/docs/dummySlug/Tutorial/Overlays	/ja/docs/Mozilla/Tech/XUL/Tutorial/Overlays
/ja/docs/dummySlug/Tutorial/Persistent_Data	/ja/docs/Archive/Mozilla/XUL/Tutorial/Persistent_Data
/ja/docs/dummySlug/Tutorial/Popup_Menus	/ja/docs/Archive/Mozilla/XUL/Tutorial/Popup_Menus
/ja/docs/dummySlug/Tutorial/Progress_Meters	/ja/docs/Archive/Mozilla/XUL/Tutorial/Progress_Meters
/ja/docs/dummySlug/Tutorial/Property_Files	/ja/docs/Archive/Mozilla/XUL/Tutorial/Property_Files
/ja/docs/dummySlug/Tutorial/RDF_Datasources	/ja/docs/Archive/Mozilla/XUL/Tutorial/RDF_Datasources
/ja/docs/dummySlug/Tutorial/Scroll_Bars	/ja/docs/Archive/Mozilla/XUL/Tutorial/Scroll_Bars
/ja/docs/dummySlug/Tutorial/Scrolling_Menus	/ja/docs/Archive/Mozilla/XUL/Tutorial/Scrolling_Menus
/ja/docs/dummySlug/Tutorial/Simple_Menu_Bars	/ja/docs/Archive/Mozilla/XUL/Tutorial/Simple_Menu_Bars
/ja/docs/dummySlug/Tutorial/Splitters	/ja/docs/Archive/Mozilla/XUL/Tutorial/Splitters
/ja/docs/dummySlug/Tutorial/Stack_Positioning	/ja/docs/Archive/Mozilla/XUL/Tutorial/Stack_Positioning
/ja/docs/dummySlug/Tutorial/Stacks_and_Decks	/ja/docs/Archive/Mozilla/XUL/Tutorial/Stacks_and_Decks
/ja/docs/dummySlug/Tutorial/Styling_a_Tree	/ja/docs/Archive/Mozilla/XUL/Tutorial/Styling_a_Tree
/ja/docs/dummySlug/Tutorial/Tabboxes	/ja/docs/Archive/Mozilla/XUL/Tutorial/Tabboxes
/ja/docs/dummySlug/Tutorial/Templates	/ja/docs/Archive/Mozilla/XUL/Tutorial/Templates
/ja/docs/dummySlug/Tutorial/The_Box_Model	/ja/docs/Archive/Mozilla/XUL/Tutorial/The_Box_Model
/ja/docs/dummySlug/Tutorial/The_Chrome_URL	/ja/docs/Archive/Mozilla/XUL/Tutorial/The_Chrome_URL
/ja/docs/dummySlug/Tutorial/Toolbars	/ja/docs/Archive/Mozilla/XUL/Tutorial/Toolbars
/ja/docs/dummySlug/Tutorial/Tree_Box_Objects	/ja/docs/Archive/Mozilla/XUL/Tutorial/Tree_Box_Objects
/ja/docs/dummySlug/Tutorial/Tree_Selection	/ja/docs/Archive/Mozilla/XUL/Tutorial/Tree_Selection
/ja/docs/dummySlug/Tutorial/Tree_View_Details	/ja/docs/Archive/Mozilla/XUL/Tutorial/Tree_View_Details
/ja/docs/dummySlug/Tutorial/Trees	/ja/docs/Archive/Mozilla/XUL/Tutorial/Trees
/ja/docs/dummySlug/Tutorial/Trees_and_Templates	/ja/docs/Archive/Mozilla/XUL/Tutorial/Trees_and_Templates
/ja/docs/dummySlug/Tutorial/Updating_Commands	/ja/docs/Archive/Mozilla/XUL/Tutorial/Updating_Commands
/ja/docs/dummySlug/Tutorial/Using_Spacers	/ja/docs/Archive/Mozilla/XUL/Tutorial/Using_Spacers
/ja/docs/dummySlug/Tutorial/XBL_Attribute_Inheritance	/ja/docs/Archive/Mozilla/XUL/Tutorial/XBL_Attribute_Inheritance
/ja/docs/dummySlug/Tutorial/XBL_Example	/ja/docs/Archive/Mozilla/XUL/Tutorial/XBL_Example
/ja/docs/dummySlug/Tutorial/XBL_Inheritance	/ja/docs/Archive/Mozilla/XUL/Tutorial/XBL_Inheritance
/ja/docs/dummySlug/Tutorial/XPCOM_Examples	/ja/docs/Archive/Mozilla/XUL/Tutorial/XPCOM_Examples
/ja/docs/dummySlug/Tutorial/XPCOM_Interfaces	/ja/docs/Archive/Mozilla/XUL/Tutorial/XPCOM_Interfaces
/ja/docs/dummySlug/Tutorial/XUL_Structure	/ja/docs/Archive/Mozilla/XUL/Tutorial/XUL_Structure
/ja/docs/imgILoader	/ja/docs/Mozilla/Tech/XPCOM/Reference/XPCOM_Interface_Reference/imgILoader
/ja/docs/mozIRegistry	/ja/docs/Mozilla/Tech/XPCOM/Reference/XPCOM_Interface_Reference/mozIRegistry
/ja/docs/mozIStorageStatementParams	/ja/docs/Mozilla/Tech/XPCOM/Reference/XPCOM_Interface_Reference/mozIStorageStatementParams
/ja/docs/nsCOMPtr	/ja/docs/Mozilla/Tech/XPCOM/Reference/Glue_classes/nsCOMPtr
/ja/docs/nsCategoryManager	/ja/docs/Mozilla/Tech/XPCOM/Reference/Components/nsCategoryManager
/ja/docs/nsDirectoryService	/ja/docs/Mozilla/Tech/XPCOM/Reference/Components/nsDirectoryService
/ja/docs/nsIAccessible	/ja/docs/Mozilla/Tech/XPCOM/Reference/XPCOM_Interface_Reference/nsIAccessible
/ja/docs/nsIAccessibleProvider	/ja/docs/Mozilla/Tech/XPCOM/Reference/XPCOM_Interface_Reference/nsIAccessibleProvider
/ja/docs/nsIAnnotationObserver	/ja/docs/Mozilla/Tech/XPCOM/Reference/XPCOM_Interface_Reference/nsIAnnotationObserver
/ja/docs/nsIConsoleService	/ja/docs/Mozilla/Tech/XPCOM/Reference/XPCOM_Interface_Reference/nsIConsoleService
/ja/docs/nsIContentPrefObserver	/ja/docs/Mozilla/Tech/XPCOM/Reference/XPCOM_Interface_Reference/nsIContentPrefObserver
/ja/docs/nsIContentPrefService	/ja/docs/Mozilla/Tech/XPCOM/Reference/XPCOM_Interface_Reference/nsIContentPrefService
/ja/docs/nsICryptoHash	/ja/docs/Mozilla/Tech/XPCOM/Reference/XPCOM_Interface_Reference/nsICryptoHash
/ja/docs/nsIDOMFile	/ja/docs/Mozilla/Tech/XPCOM/Reference/XPCOM_Interface_Reference/nsIDOMFile
/ja/docs/nsIDOMFileException	/ja/docs/Mozilla/Tech/XPCOM/Reference/XPCOM_Interface_Reference/nsIDOMFileException
/ja/docs/nsIDOMFileList	/ja/docs/Mozilla/Tech/XPCOM/Reference/XPCOM_Interface_Reference/nsIDOMFileList
/ja/docs/nsIDOMOfflineResourceList	/ja/docs/Mozilla/Tech/XPCOM/Reference/XPCOM_Interface_Reference/nsIDOMOfflineResourceList
/ja/docs/nsIDownload	/ja/docs/Mozilla/Tech/XPCOM/Reference/XPCOM_Interface_Reference/nsIDownload
/ja/docs/nsIDownloadManager	/ja/docs/Mozilla/Tech/XPCOM/Reference/XPCOM_Interface_Reference/nsIDownloadManager
/ja/docs/nsIDownloadManagerUI	/ja/docs/Mozilla/Tech/XPCOM/Reference/XPCOM_Interface_Reference/nsIDownloadManagerUI
/ja/docs/nsIDownloadProgressListener	/ja/docs/Mozilla/Tech/XPCOM/Reference/XPCOM_Interface_Reference/nsIDownloadProgressListener
/ja/docs/nsIDragService	/ja/docs/Mozilla/Tech/XPCOM/Reference/XPCOM_Interface_Reference/nsIDragService
/ja/docs/nsIEffectiveTLDService	/ja/docs/Mozilla/Tech/XPCOM/Reference/XPCOM_Interface_Reference/nsIEffectiveTLDService
/ja/docs/nsIFeed	/ja/docs/Mozilla/Tech/XPCOM/Reference/XPCOM_Interface_Reference/nsIFeed
/ja/docs/nsIFeedContainer	/ja/docs/Mozilla/Tech/XPCOM/Reference/XPCOM_Interface_Reference/nsIFeedContainer
/ja/docs/nsIFeedElementBase	/ja/docs/Mozilla/Tech/XPCOM/Reference/XPCOM_Interface_Reference/nsIFeedElementBase
/ja/docs/nsIFeedEntry	/ja/docs/Mozilla/Tech/XPCOM/Reference/XPCOM_Interface_Reference/nsIFeedEntry
/ja/docs/nsIFeedGenerator	/ja/docs/Mozilla/Tech/XPCOM/Reference/XPCOM_Interface_Reference/nsIFeedGenerator
/ja/docs/nsIFeedPerson	/ja/docs/Mozilla/Tech/XPCOM/Reference/XPCOM_Interface_Reference/nsIFeedPerson
/ja/docs/nsIFeedProcessor	/ja/docs/Mozilla/Tech/XPCOM/Reference/XPCOM_Interface_Reference/nsIFeedProcessor
/ja/docs/nsIFeedProgressListener	/ja/docs/Mozilla/Tech/XPCOM/Reference/XPCOM_Interface_Reference/nsIFeedProgressListener
/ja/docs/nsIFeedResult	/ja/docs/Mozilla/Tech/XPCOM/Reference/XPCOM_Interface_Reference/nsIFeedResult
/ja/docs/nsIFeedResultListener	/ja/docs/Mozilla/Tech/XPCOM/Reference/XPCOM_Interface_Reference/nsIFeedResultListener
/ja/docs/nsIFeedTextConstruct	/ja/docs/Mozilla/Tech/XPCOM/Reference/XPCOM_Interface_Reference/nsIFeedTextConstruct
/ja/docs/nsIHttpActivityDistributor	/ja/docs/Mozilla/Tech/XPCOM/Reference/XPCOM_Interface_Reference/nsIHttpActivityDistributor
/ja/docs/nsIHttpActivityObserver	/ja/docs/Mozilla/Tech/XPCOM/Reference/XPCOM_Interface_Reference/nsIHttpActivityObserver
/ja/docs/nsIIdleService	/ja/docs/Mozilla/Tech/XPCOM/Reference/XPCOM_Interface_Reference/nsIIdleService
/ja/docs/nsIInputStream	/ja/docs/Mozilla/Tech/XPCOM/Reference/XPCOM_Interface_Reference/nsIInputStream
/ja/docs/nsIJSCID	/ja/docs/Mozilla/Tech/XPCOM/Reference/XPCOM_Interface_Reference/nsIJSCID
/ja/docs/nsIJSON	/ja/docs/Mozilla/Tech/XPCOM/Reference/XPCOM_Interface_Reference/nsIJSON
/ja/docs/nsILoginInfo	/ja/docs/Mozilla/Tech/XPCOM/Reference/XPCOM_Interface_Reference/nsILoginInfo
/ja/docs/nsILoginManager	/ja/docs/Mozilla/Tech/XPCOM/Reference/XPCOM_Interface_Reference/nsILoginManager
/ja/docs/nsIObserver	/ja/docs/Mozilla/Tech/XPCOM/Reference/XPCOM_Interface_Reference/nsIObserver
/ja/docs/nsIObserverService	/ja/docs/Mozilla/Tech/XPCOM/Reference/XPCOM_Interface_Reference/nsIObserverService
/ja/docs/nsIOutputStream	/ja/docs/Mozilla/Tech/XPCOM/Reference/XPCOM_Interface_Reference/nsIOutputStream
/ja/docs/nsIParentalControlsService	/ja/docs/Mozilla/Tech/XPCOM/Reference/XPCOM_Interface_Reference/nsIParentalControlsService
/ja/docs/nsIPassword	/ja/docs/Mozilla/Tech/XPCOM/Reference/XPCOM_Interface_Reference/nsIPassword
/ja/docs/nsIPasswordManager	/ja/docs/Mozilla/Tech/XPCOM/Reference/XPCOM_Interface_Reference/nsIPasswordManager
/ja/docs/nsIScriptableUnescapeHTML	/ja/docs/Mozilla/Tech/XPCOM/Reference/XPCOM_Interface_Reference/nsIScriptableUnescapeHTML
/ja/docs/nsIScriptableUnicodeConverter	/ja/docs/Mozilla/Tech/XPCOM/Reference/XPCOM_Interface_Reference/nsIScriptableUnicodeConverter
/ja/docs/nsISessionStore	/ja/docs/Mozilla/Tech/XPCOM/Reference/XPCOM_Interface_Reference/nsISessionStore
/ja/docs/nsISupports_proxies	/ja/docs/Mozilla/Tech/XPCOM/Reference/XPCOM_Interface_Reference/nsISupports_proxies
/ja/docs/nsITaggingService	/ja/docs/Mozilla/Tech/XPCOM/Reference/XPCOM_Interface_Reference/nsITaggingService
/ja/docs/nsIThread	/ja/docs/Mozilla/Tech/XPCOM/Reference/XPCOM_Interface_Reference/nsIThread
/ja/docs/nsIThreadEventFilter	/ja/docs/Mozilla/Tech/XPCOM/Reference/XPCOM_Interface_Reference/nsIThreadEventFilter
/ja/docs/nsIThreadInternal	/ja/docs/Mozilla/Tech/XPCOM/Reference/XPCOM_Interface_Reference/nsIThreadInternal
/ja/docs/nsIThreadManager	/ja/docs/Mozilla/Tech/XPCOM/Reference/XPCOM_Interface_Reference/nsIThreadManager
/ja/docs/nsIThreadObserver	/ja/docs/Mozilla/Tech/XPCOM/Reference/XPCOM_Interface_Reference/nsIThreadObserver
/ja/docs/nsIThreadPool	/ja/docs/Mozilla/Tech/XPCOM/Reference/XPCOM_Interface_Reference/nsIThreadPool
/ja/docs/nsIWebProgressListener	/ja/docs/Mozilla/Tech/XPCOM/Reference/XPCOM_Interface_Reference/nsIWebProgressListener
/ja/docs/nsIWindowMediator	/ja/docs/Mozilla/Tech/XPCOM/Reference/XPCOM_Interface_Reference/nsIWindowMediator
/ja/docs/nsIZipEntry	/ja/docs/Mozilla/Tech/XPCOM/Reference/XPCOM_Interface_Reference/nsIZipEntry
/ja/docs/nsIZipReader	/ja/docs/Mozilla/Tech/XPCOM/Reference/XPCOM_Interface_Reference/nsIZipReader
/ja/docs/nsIZipWriter	/ja/docs/Mozilla/Tech/XPCOM/Reference/XPCOM_Interface_Reference/nsIZipWriter
/ja/docs/nsLocalFile	/ja/docs/Mozilla/Tech/XPCOM/Reference/Components/nsLocalFile
/ja/docs/nsObserverService	/ja/docs/Mozilla/Tech/XPCOM/Reference/Components/nsObserverService
/ja/docs/persona/Browser_compatibility	/ja/docs/Mozilla/Persona/Browser_compatibility
/ja/docs/persona/Internationalization	/ja/docs/Mozilla/Persona/Internationalization
/ja/docs/toolkit.defaultChromeFeatures	/ja/docs/Archive/Mozilla/XULRunner/toolkit.defaultChromeFeatures
/ja/docs/toolkit.singletonWindowType	/ja/docs/Archive/Mozilla/XULRunner/toolkit.singletonWindowType
/ja/docs/wrappedJSObject	/ja/docs/Mozilla/Tech/XPCOM/wrappedJSObject
/ja/docs/xptcall_FAQ	/ja/docs/Mozilla/Tech/XPCOM/xptcall_FAQ
